КРАЕВОЕ ГОСУДАРСТВЕННОЕ БЮДЖЕТНОЕ ПРОФЕССИОНАЛЬНОЕ ОБРАЗОВАТЕЛЬНОЕ УЧРЕЖДЕНИЕ	КГБПОУ
АВТОНОМНОЙ НЕКОММЕРЧЕСКОЙ ОБРАЗОВАТЕЛЬНОЙ ОРГАНИЗАЦИИ	АНОО
АВТОНОМНАЯ НЕКОММЕРЧЕСКАЯ ПРОФЕССИОНАЛЬНАЯ ОБРАЗОВАТЕЛЬНАЯ ОРГАНИЗАЦИЯ	АНПОО
ГОСУДАРСТВЕННОЕ ПРОФЕССИОНАЛЬНОЕ ОБРАЗОВАТЕЛЬНОЕ БЮДЖЕТНОЕ УЧРЕЖДЕНИЕ	ГПОБУ
ГОСУДАРСТВЕННОЕ ОБЛАСТНОЕ БЮДЖЕТНОЕ УЧРЕЖДЕНИЕ	ГО БУ
ГОСУДАРСТВЕННОЕ ОБРАЗОВАТЕЛЬНОЕ БЮДЖЕТНОЕ УЧРЕЖДЕНИЕ	ГОБУ
ГОСУДАРСТВЕННАЯ БЮДЖЕТНАЯ ПРОФЕССИОНАЛЬНАЯ ОБРАЗОВАТЕЛЬНАЯ ОРГАНИЗАЦИЯ	ГБПОО
ГОСУДАРСТВЕННАЯ ПРОФЕССИОНАЛЬНАЯ ОБРАЗОВАТЕЛЬНАЯ ОРГАНИЗАЦИЯ	ГПОО
государственное бюджетное ПРОФЕССИОНАЛЬНОЕ УЧРЕЖДЕНИЕ	ГБПУ
государственном бюджетном учреждении культуры	ГБУК
ОБЛАСТНОЕ ГОСУДАРСТВЕННОЕ БЮДЖЕТНОЕ ОБРАЗОВАТЕЛЬНОЕ УЧРЕЖДЕНИЕ	ОГБОУ
ОБЛАСТНОЕ ГОСУДАРСТВЕННОЕ КАЗЁННОЕ ОБРАЗОВАТЕЛЬНОЕ УЧРЕЖДЕНИЕ	ОГКОУ
ФЕДЕРАЛЬНОЕ ГОСУДАРСТВЕННОЕ КАЗЁННОЕ ОБРАЗОВАТЕЛЬНОЕ УЧРЕЖДЕНИЕ	ФГКОУ
ФЕДЕРАЛЬНОЕ ГОСУДАРСТВЕННОЕ АВТОНОМНОЕ ОБРАЗОВАТЕЛЬНОЕ УЧРЕЖДЕНИЕ	ФГАОУ
ФЕДЕРАЛЬНОЕ ГОСУДАРСТВЕННОЕ БЮДЖЕТНОЕ ОБРАЗОВАТЕЛЬНОЕ УЧРЕЖДЕНИЕ	ФГБОУ
ФЕДЕРАЛЬНОЕ ГОСУДАРСТВЕННОЕ ОБРАЗОВАТЕЛЬНОЕ БЮДЖЕТНОЕ УЧРЕЖДЕНИЕ	ФГОБУ
ФЕДЕРАЛЬНОЕ ГОСУДАРСТВЕННОЕ БЮДЖЕТНОЕ ОБРАЗОВАТЕЛЬНОЕ УЧРЕЖДЕНИЕ	ФГБОУ
ФЕДЕРАЛЬНОЕ ГОСУДАРСТВЕННОЕ КАЗЕННОЕ ВОЕННОЕ ОБРАЗОВАТЕЛЬНОЕ УЧРЕЖДЕНИЕ	ФГКВОУ
ФЕДЕРАЛЬНОЕ ГОСУДАРСТВЕННОЕ ВОЕННОЕ ОБРАЗОВАТЕЛЬНОЕ УЧРЕЖДЕНИЕ	ФГВОУ
ФЕДЕРАЛЬНОЕ ГОСУДАРСТВЕННОЕ УНИТАРНОЕ ПРЕДПРИЯТИЕ	ФГУП
ФЕДЕРАЛЬНОЕ ГОСУДАРСТВЕННОЕ ПРЕДПРИЯТИЕ	ФГП
ГОСУДАРСТВЕННОЕ ОБЛАСТНОЕ КАЗЕННОЕ УЧРЕЖДЕНИЕ	ГОКУ
ГОСУДАРСТВЕННОЕ БЮДЖЕТНОЕ ПРОФЕССИОНАЛЬНОЕ ОБРАЗОВАТЕЛЬНОЕ УЧРЕЖДЕНИЕ	ГБПОУ
государственного бюджетного профессионального образования учреждения	ГБПОУ
ФЕДЕРАЛЬНОЕ ГОСУДАРСТВЕННОЕ ОБРАЗОВАТЕЛЬНОЕ УЧРЕЖДЕНИЕ	ФГОУ
МУНИЦИПАЛЬНОЕ АВТОНОМНОЕ ДОШКОЛЬНОЕ ОБРАЗОВАТЕЛЬНОЕ УЧРЕЖДЕНИЕ	МАДОУ
МУНИЦИПАЛЬНОЕ АВТОНОМНОЕ ОБРАЗОВАТЕЛЬНОЕ УЧРЕЖДЕНИЕ	МАОУ
МУНИЦИПАЛЬНОЕ БЮДЖЕТНОЕ ОБРАЗОВАТЕЛЬНОЕ УЧРЕЖДЕНИЕ	МБОУ
МУНИЦИПАЛЬНОЕ БЮДЖЕТНОЕ ДОШКОЛЬНОЕ ОБРАЗОВАТЕЛЬНОЕ УЧРЕЖДЕНИЕ	МБДОУ
МУНИЦИПАЛЬНОЕ ОБРАЗОВАТЕЛЬНОЕ БЮДЖЕТНОЕ УЧРЕЖДЕНИЕ	МОБУ
МУНИЦИПАЛЬНОЕ КАЗЁННОЕ ОБРАЗОВАТЕЛЬНОЕ УЧРЕЖДЕНИЕ	МКОУ
МУНИЦИПАЛЬНОЕ ОБРАЗОВАТЕЛЬНОЕ КАЗЁННОЕ УЧРЕЖДЕНИЕ	МОКУ
МУНИЦИПАЛЬНОЕ ДОШКОЛЬНОЕ ОБРАЗОВАТЕЛЬНОЕ УЧРЕЖДЕНИЕ	МДОУ
МУНИЦИПАЛЬНОЕ ОБРАЗОВАТЕЛЬНОЕ УЧРЕЖДЕНИЕ	МОУ
КРАЕВОЕ ГОСУДАРСТВЕННОЕ БЮДЖЕТНОЕ ОБРАЗОВАТЕЛЬНОЕ УЧРЕЖДЕНИЕ	КГБОУ
КРАЕВОЕ ГОСУДАРСТВЕННОЕ ОБРАЗОВАТЕЛЬНОЕ УЧРЕЖДЕНИЕ	КГОУ
ГОСУДАРСТВЕННОЕ АВТОНОМНОЕ ОБРАЗОВАТЕЛЬНОЕ УЧРЕЖДЕНИЕ	ГАОУ
ГОСУДАРСТВЕННОГО КАЗЕННОГО ВОЕННОГО ОБРАЗОВАТЕЛЬНОГО УЧРЕЖДЕНИЯ	ГКВОУ
ГОСУДАРСТВЕННОЕ БЮДЖЕТНОЕ ОБРАЗОВАТЕЛЬНОЕ УЧРЕЖДЕНИЕ	ГБОУ
ГОСУДАРСТВЕННОЕ БЮДЖЕТНОЕ ПРОФЕССИОНАЛЬНОЕ ОБРАЗОВАТЕЛЬНОЕ УЧРЕЖДЕНИЕ	ГБПОУ
ГОСУДАРСТВЕННОЕ АВТОНОМНОЕ ПРОФЕССИОНАЛЬНОЕ ОБРАЗОВАТЕЛЬНОЕ УЧРЕЖДЕНИЕ	ГАПОУ
ГОСУДАРСТВЕННОЕ КАЗЁННОЕ ОБРАЗОВАТЕЛЬНОЕ УЧРЕЖДЕНИЕ	ГКОУ
ГОСУДАРСТВЕННОЕ ПРОФЕССИОНАЛЬНОЕ ОБРАЗОВАТЕЛЬНОЕ УЧРЕЖДЕНИЕ	ГПОУ
НЕГОСУДАРСТВЕННОЕ АККРЕДИТОВАННОЕ ЧАСТНОЕ ОБРАЗОВАТЕЛЬНОЕ УЧРЕЖДЕНИЕ	НАЧОУ
НЕГОСУДАРСТВЕННОЕ ЧАСТНОЕ ОБРАЗОВАТЕЛЬНОЕ УЧРЕЖДЕНИЕ	НЧОУ
ЧАСТНОЕ ПРОФЕССИОНАЛЬНОЕ ОБРАЗОВАТЕЛЬНОЕ УЧРЕЖДЕНИЕ	ЧПОУ
ОБЛАСТНОЕ БЮДЖЕТНОЕ ОБРАЗОВАТЕЛЬНОЕ УЧРЕЖДЕНИЕ	ОБОУ
ОБЛАСТНОЕ ГОСУДАРСТВЕННОЕ ОБРАЗОВАТЕЛЬНОЕ УЧРЕЖДЕНИЕ	ОГОУ
ОБЛАСТНОЕ КАЗЁННОЕ ОБРАЗОВАТЕЛЬНОЕ УЧРЕЖДЕНИЕ	ОКОУ
ФЕДЕРАЛЬНОЕ КАЗЁННОЕ ПРОФЕССИОНАЛЬНОЕ ОБРАЗОВАТЕЛЬНОЕ УЧРЕЖДЕНИЕ	ФКПОУ
БЮДЖЕТНОЕ ПРОФЕССИОНАЛЬНОЕ ОБРАЗОВАТЕЛЬНОЕ УЧРЕЖДЕНИЕ	БПОУ
ГОСУДАРСТВЕННОЕ ОБРАЗОВАТЕЛЬНОЕ КАЗЁННОЕ УЧРЕЖДЕНИЕ	ГОКУ
МУНИЦИПАЛЬНОЕ ОБРАЗОВАТЕЛЬНОЕ АВТОНОМНОЕ УЧРЕЖДЕНИЕ	МОАУ
МУНИЦИПАЛЬНОЕ ОБРАЗОВАТЕЛЬНОЕ БЮДЖЕТНОЕ УЧРЕЖДЕНИЕ	МОБУ
МУНИЦИПАЛЬНОЕ ОБРАЗОВАТЕЛЬНОЕ КАЗЁННОЕ УЧРЕЖДЕНИЕ	МОКУ
НЕГОСУДАРСТВЕННОЕ ОБРАЗОВАТЕЛЬНОЕ ЧАСТНОЕ УЧРЕЖДЕНИЕ	НОЧУ
ПРОФЕССИОНАЛЬНОЕ ОБРАЗОВАТЕЛЬНОЕ ЧАСТНОЕ УЧРЕЖДЕНИЕ	ПОЧУ
ФЕДЕРАЛЬНОЕ ГОСУДАРСТВЕННОЕ АВТОНОМНОЕ УЧРЕЖДЕНИЕ	ФГАУ
ФЕДЕРАЛЬНОЕ ГОСУДАРСТВЕННОЕ БЮДЖЕТНОЕ УЧРЕЖДЕНИЕ НАУКИ	ФГБУН
ФЕДЕРАЛЬНОЕ ГОСУДАРСТВЕННОЕ БЮДЖЕТНОЕ УЧРЕЖДЕНИЕ	ФГБУ
ФЕДЕРАЛЬНОЕ ГОСУДАРСТВЕННОЕ КАЗЁННОЕ УЧРЕЖДЕНИЕ	ФГКУ
АВТОНОМНОЕ ОБРАЗОВАТЕЛЬНОЕ УЧРЕЖДЕНИЕ	АОУ
ОБРАЗОВАТЕЛЬНАЯ АВТОНОМНАЯ НЕКОММЕРЧЕСКАЯ ОРГАНИЗАЦИЯ	ОАНО
АВТОНОМНАЯ НЕКОММЕРЧЕСКАЯ ОРГАНИЗАЦИЯ ПРОФЕССИОНАЛЬНОГО ОБРАЗОВАНИЯ	АНО ПО
АВТОНОМНАЯ НЕКОММЕРЧЕСКАЯ ОРГАНИЗАЦИЯ	АНО
ФЕДЕРАЛЬНОЕ БЮДЖЕТНОЕ УЧРЕЖДЕНИЕ ЗДРАВООХРАНЕНИЯ	ФБУЗ
ФЕДЕРАЛЬНОЕ ГОСУДАРСТВЕННОЕ БЮДЖЕТНОЕ НАУЧНОЕ УЧРЕЖДЕНИЕ	ФГБНУ
ФЕДЕРАЛЬНОЕ ГОСУДАРСТВЕННОЕ АВТОНОМНОЕ НАУЧНОЕ УЧРЕЖДЕНИЕ	ФГАНУ
АККРЕДИТОВАННОГО ОБРАЗОВАТЕЛЬНОГО ЧАСТНОГО УЧРЕЖДЕНИЯ	АОЧУ
ОБРАЗОВАТЕЛЬНОГО ЧАСТНОГО УЧРЕЖДЕНИЯ	ОЧУ
ЧАСТНОЕ УЧРЕЖДЕНИЕ ОБРАЗОВАТЕЛЬНАЯ ОРГАНИЗАЦИЯ	ЧУОО
Частного учреждения (- )?профессиональной образовательной организации	ЧУПОО
Частное учреждение ПРОФЕССИОНАЛЬНОГО ОБРАЗОВАНИЯ	ЧУ ПО
#Частное учреждение	ЧУ
ГОСУДАРСТВЕННОЕ ПРОФЕССИОНАЛЬНОЕ ОБРАЗОВАТЕЛЬНОЕ АВТОНОМНОЕ УЧРЕЖДЕНИЕ	ГПОАУ
КРАЕВОЕ ГОСУДАРСТВЕННОЕ ОБРАЗОВАТЕЛЬНОЕ БЮДЖЕТНОЕ УЧРЕЖДЕНИЕ	КГОБУ
БЮДЖЕТНОЕ ОБРАЗОВАТЕЛЬНОЕ УЧРЕЖДЕНИЕ	БОУ
НЕГОСУДАРСТВЕННОЕ ОБРАЗОВАТЕЛЬНОЕ УЧРЕЖДЕНИЕ	НОУ
ГОСУДАРСТВЕННОЕ ОБРАЗОВАТЕЛЬНОЕ УЧРЕЖДЕНИЕ	ГОУ
ГОСУДАРСТВЕННОЕ АВТОНОМНОЕ УЧРЕЖДЕНИЕ	ГАУ
ГОСУДАРСТВЕННОЕ БЮДЖЕТНОЕ УЧРЕЖДЕНИЕ ОБРАЗОВАТЕЛЬНАЯ ОРГАНИЗАЦИЯ	ГБУ ОО
ГОСУДАРСТВЕННОЕ БЮДЖЕТНОЕ УЧРЕЖДЕНИЕ ЗДРАВООХРАНЕНИЯ	ГБУЗ
ГОСУДАРСТВЕННОЕ БЮДЖЕТНОЕ УЧРЕЖДЕНИЕ	ГБУ
ГОСУДАРСТВЕННОЕ КАЗЁННОЕ УЧРЕЖДЕНИЕ	ГКУ
МУНИЦИПАЛЬНОЕ БЮДЖЕТНОЕ УЧРЕЖДЕНИЕ	МБУ
МУНИЦИПАЛЬНОЕ АВТОНОМНОЕ УЧРЕЖДЕНИЕ	МАУ
МУНИЦИПАЛЬНОЕ КАЗЁННОЕ УЧРЕЖДЕНИЕ	МКУ
КАЗЁННОЕ ОБРАЗОВАТЕЛЬНОЕ УЧРЕЖДЕНИЕ	КОУ
МУНИЦИПАЛЬНОЕ ОБРАЗОВАТЕЛЬНОЕ УЧРЕЖДЕНИЕ	МОУ
МУНИЦИПАЛЬНОЕ КАЗЁННОЕ УЧРЕЖДЕНИЕ	МКУ
МУНИЦИПАЛЬНОЕ ОБРАЗОВАТЕЛЬНОЕ УЧРЕЖДЕНИЕ	МОУ
ПРОФЕССИОНАЛЬНОЕ ОБРАЗОВАТЕЛЬНОЕ УЧРЕЖДЕНИЕ	ПОУ
ЧАСТНОЕ ОБРАЗОВАТЕЛЬНОЕ УЧРЕЖДЕНИЕ	ЧОУ
ДОШКОЛЬНОЕ ОБРАЗОВАТЕЛЬНОЕ УЧРЕЖДЕНИЕ	ДОУ
ОСНОВНАЯ ОБЩЕОБРАЗОВАТЕЛЬНАЯ ШКОЛА	ООШ
СРЕДНЯЯ ОБЩЕОБРАЗОВАТЕЛЬНАЯ ШКОЛА	СОШ
НАЧАЛЬНАЯ ОБЩЕОБРАЗОВАТЕЛЬНАЯ ШКОЛ	НОШ
ВЫСШЕГО ПРОФЕССИОНАЛЬНОГО ОБРАЗОВАНИЯ	ВПО
ВЫСШЕГО ОБРАЗОВАНИЯ	ВО
ДОПОЛНИТЕЛЬНОГО ПРОФЕССИОНАЛЬНОГО ОБРАЗОВАНИЯ	ДПО
ДОПОЛНИТЕЛЬНОГО ОБРАЗОВАНИЯ	ДЕТЕЙ	ДОД
ДОПОЛНИТЕЛЬНОГО ОБРАЗОВАНИЯ	ДО
НАЧАЛЬНОГО ПРОФЕССИОНАЛЬНОГО ОБРАЗОВАНИЯ	НПО
СРЕДНЕГО ПРОФЕССИОНАЛЬНОГО ОБРАЗОВАНИЯ	СПО
филиал УЧРЕЖДЕНИЯ ПРОФЕССИОНАЛЬНОГО ОБРАЗОВАНИЯ	филиал УПО
#ПРОФЕССИОНАЛЬНОГО ОБРАЗОВАНИЯ	ПО
УЧЕБНО-КОНСУЛЬТАЦИОННЫЙ ПУНКТ	УКП
ОБРАЗОВАТЕЛЬНОГО ЧАСТНОГО УЧРЕЖДЕНИЯ	ОЧУ
ОБРАЗОВАТЕЛЬНОГО УЧРЕЖДЕНИЯ ПРОФСОЮЗОВ	ОУП
ОБРАЗОВАТЕЛЬНОГО УЧРЕЖДЕНИЯ	ОУ
МУНИЦИПАЛЬНОЕ ДОШКОЛЬНОЕ ОБРАЗОВАТЕЛЬНОЕ БЮДЖЕТНОЕ УЧРЕЖДЕНИЕ	МДОБУ
общероссийской общественно(-| )государственной организации добровольное общество содействия армии,? авиации и флоту России	ДОСААФ
общероссийской общественной организации всероссийское добровольное пожарное общество	ВДПО
всероссийское ордена трудового красного знамени общество слепых	ВОС
министерства Российской Федерации по делам гражданской обороны, чрезвычайным ситуациям и ликвидации последствий стихийных бедствий	МЧС России
НАУЧНО-ИССЛЕДОВАТЕЛЬСКИЙ ИНСТИТУТ	НИИ
НАЦИОНАЛЬНЫЙ МЕДИЦИНСКИЙ ИССЛЕДОВАТЕЛЬСКИЙ ЦЕНТР	НМИЦ
ИССЛЕДОВАТЕЛЬСКИЙ ЦЕНТР	ИЦ
Общество с Ограниченной Ответственностью	ООО
Публичное акционерное общество	ПАО
открытого акционерного общества	ОАО
акционерное общество	АО
российские железные дороги	РЖД
Средняя общеобразовательная школа	СОШ
Средняя общеобразовательная Русско-Татарская школа	русско-татарская СОШ
Средняя школа	СШ
Основная общеобразовательная школа	ООШ
открытая \(?сменная\)? общеобразовательная школа	ОСОШ
Начальная общеобразовательная школа	НОШ
Вечерняя \(?сменная\)? общеобразовательная школа	В(С)ОШ
Специальная \(?коррекционная\)? общеобразовательная школа-интернат	С(К)ОШИ
Специальная \(?коррекционная\)? школа-интернат	С(К)ШИ
Специальная \(?коррекционная\)? общеобразовательная школа	С(К)ОШ
ОБЩЕОБРАЗОВАТЕЛЬНАЯ ШКОЛА-ИНТЕРНАТ	ОШИ
Специальное учебно-воспитательное общеобразовательное учреждение	СУВОУ
специальное учебно-воспитательное учреждение	СУВУ
специальное учебно-воспитательное	СУВ
российской академии наук	РАН
сибирского отделения	СО
уральского отделения	УрО
дальневосточного отделения	ДО
государственной противопожарной службы	ГПС
школа\s?-\s?интернат	ШИ
Учебно-воспитательный комплекс	УВК
Центр образования	ЦО
при федеральном каз(е|ё)нном учреждении исправительная колония	при ИК
ФЕДЕРАЛЬНОМ КАЗЁННОМ УЧРЕЖДЕНИИ	ФКУ
Управления Федеральной службы исполнения наказаний	ФСИН
ОБЩЕОБРАЗОВАТЕЛЬНАЯ ШКОЛА	ОШ
#основная школа	ОШ
Индивидуальный предприниматель	ИП
учебно-методический центр по гражданской обороне и чрезвычайным ситуациям	УМЦ по ГО и ЧС
учреждение социального обслуживания	УСО
ВОЕННЫЙ УЧЕБНО-НАУЧНЫЙ ЦЕНТР	ВУНЦ
федеральное медико-биологическое агентство	ФМБА
федеральный научно-клинический центр	ФНКЦ	
по гражданской обороне, чрезвычайным ситуациям, пожарной безопасности	по ГО, ЧС, ПО
региональное общественно-государственное объединение	РОГО
добровольное общество содействия армии, авиации и флоту \(ДОСААФ\)	ДОСААФ
по делам гражданской обороны, чрезвычайным ситуациям и ликвидации последствий стихийных бедствий	по делам ГОЧС
федеральное бюджетное учреждение науки	ФБУН
федеральное бюджетное учреждение	ФБУ
информационно-методический центр	ИМЦ
русской православной церкви	РПЦ
всероссийское общество автомобилистов	ВОА
Федеральной службы исполнения наказаний	ФСИН
центр профессиональной подготовки и повышения квалификации	центр ППиПК
федерального дорожного агентства	ФДА
по гражданской обороне, чрезвычайным ситуациям и пожарной безопасности	ГОЧС И ПБ
ГБОУ профессиональной образовательной организации	ГБОУ ПОО
АНО профессиональной образовательной организации	АНО ПОО
ЧОУ профессионального образования	ЧОУ ПО
АНОО профессионального образования	АНОО ПО
НОЧУ профессиональной образовательной организации	НОЧУ ПОО
областного автономного ПОУ	ОАПОУ
Представительство частного учреждения ВО	представительство ЧУ ВО
филиал частного учреждения ВО	филиал ЧУ ВО
Представительство частного учреждения ВО	Представительство ЧУ ВО
филиал областного БПОУ	филиал ОБПОУ
филиал автономного ПОУ	 филиал АПОУ
Филиал частного учреждения образовательной организации	филиал ЧУ ОО
филиал федерального ГОБУ	филиал ФГОБУ
государственного унитарного предприятия	ГУП
Филиал частного учреждения	филиал ЧУ
филиал областного ГБПОУ	филиал ОГБПОУ
Филиал Кировского областного	филиал КО
Представительство учреждения ВО	Представительство УВО
министерства Внутренних дел Российской Федерации	МВД РФ