ГБПОУ	ГОСУДАРСТВЕННОГО БЮДЖЕТНОГО ПРОФЕССИОНАЛЬНОГО ОБРАЗОВАТЕЛЬНОГО УЧРЕЖДЕНИЯ	285
ГБПОУ	ГОСУДАРСТВЕННОЕ БЮДЖЕТНОЕ ПРОФЕССИОНАЛЬНОЕ ОБРАЗОВАТЕЛЬНОЕ УЧРЕЖДЕНИЕ	7
ИМ	ИМ. М	11
ИМ	И МОЛОЧНОЙ	1
ИМ	ИМ М	1
ИМ	ИЖЕВСКИЙ МАШИНОСТРОИТЕЛЬНЫЙ	1
ИМ	И МОЛОДЕЖНОЙ	1
ИМ	И. МЕНДЕЛЕЕВА	1
ИМ	И.МАРЕСЕВОЙ	1
ИМ	И. МАКАРОВА	1
ГБПОУ	ГОСУДАРСТВЕННОЕ БЮДЖЕТНОЕ ПРОФЕССИОНАЛЬНОЕ ОБРАЗОВАТЕЛЬНОЕ УЧРЕЖДЕНИЕ	90
ГБПОУ	ГОСУДАРСТВЕННОГО БЮДЖЕТНОГО ПРОФЕССИОНАЛЬНОГО ОБРАЗОВАТЕЛЬНОГО УЧРЕЖДЕНИЯ	5
ГАПОУ	ГОСУДАРСТВЕННОГО АВТОНОМНОГО ПРОФЕССИОНАЛЬНОГО ОБРАЗОВАТЕЛЬНОГО УЧРЕЖДЕНИЯ	98
СПО	СРЕДНЕГО ПРОФЕССИОНАЛЬНОГО ОБРАЗОВАНИЯ	61
КГБПОУ	КРАЕВОГО ГОСУДАРСТВЕННОГО БЮДЖЕТНОГО ПРОФЕССИОНАЛЬНОГО ОБРАЗОВАТЕЛЬНОГО УЧРЕЖДЕНИЯ	56
ГАПОУ	ГОСУДАРСТВЕННОЕ АВТОНОМНОЕ ПРОФЕССИОНАЛЬНОЕ ОБРАЗОВАТЕЛЬНОЕ УЧРЕЖДЕНИЕ	48
ГАПОУ	ГОСУДАРСТВЕННОГО АВТОНОМНОГО ПРОФЕССИОНАЛЬНОГО ОБРАЗОВАТЕЛЬНОГО УЧРЕЖДЕНИЯ	1
СПО	СРЕДНЕГО ПРОФЕССИОНАЛЬНОГО ОБРАЗОВАНИЯ	48
БПОУ	БЮДЖЕТНОГО ПРОФЕССИОНАЛЬНОГО ОБРАЗОВАТЕЛЬНОГО УЧРЕЖДЕНИЯ	47
НОУ	НЕГОСУДАРСТВЕННОЕ ОБРАЗОВАТЕЛЬНОЕ УЧРЕЖДЕНИЕ	37
ЧПОУ	ЧАСТНОГО ПРОФЕССИОНАЛЬНОГО ОБРАЗОВАТЕЛЬНОГО УЧРЕЖДЕНИЯ	37
АНО	АВТОНОМНОЙ НЕКОММЕРЧЕСКОЙ ОРГАНИЗАЦИИ	34
ГБОУ	ГОСУДАРСТВЕННОГО БЮДЖЕТНОГО ОБРАЗОВАТЕЛЬНОГО УЧРЕЖДЕНИЯ	29
ГБОУ	ГОСУДАРСТВЕННОЕ БЮДЖЕТНОЕ ОБРАЗОВАТЕЛЬНОЕ УЧРЕЖДЕНИЕ	1
НПО	НАЧАЛЬНОГО ПРОФЕССИОНАЛЬНОГО ОБРАЗОВАНИЯ	27
ГПОУ	ГОСУДАРСТВЕННОГО ПРОФЕССИОНАЛЬНОГО ОБРАЗОВАТЕЛЬНОГО УЧРЕЖДЕНИЯ	27
УЛ	УЛ ЛЕНИНА	2
УЛ	УЛ ЛЕОНОВА	1
ПОУ	ПРОФЕССИОНАЛЬНОГО ОБРАЗОВАТЕЛЬНОГО УЧРЕЖДЕНИЯ	24
ПОУ	ПРОФЕССИОНАЛЬНОЕ ОБРАЗОВАТЕЛЬНОЕ УЧРЕЖДЕНИЕ	1
ВКБ	ВОЛГОГРАДСКИЙ КОЛЛЕДЖ БИЗНЕСА	25
ПУ	ПРОФЕССИОНАЛЬНОЕ УЧИЛИЩЕ	21
ПУ	ПРОФЕССИОНАЛЬНОГО УЧИЛИЩА	1
ГБОУ	ГОСУДАРСТВЕННОЕ БЮДЖЕТНОЕ ОБРАЗОВАТЕЛЬНОЕ УЧРЕЖДЕНИЕ	16
ЧПОУ	ЧАСТНОЕ ПРОФЕССИОНАЛЬНОЕ ОБРАЗОВАТЕЛЬНОЕ УЧРЕЖДЕНИЕ	21
СРШБ	СИБИРСКАЯ РЕГИОНАЛЬНАЯ ШКОЛА БИЗНЕСА	21
СО	СВЕРДЛОВСКОЙ ОБЛАСТИ	17
СО	СФЕРЫ ОБСЛУЖИВАНИЯ	2
СО	САМАРСКОЙ ОБЛАСТИ	1
АНПОО	АВТОНОМНАЯ НЕКОММЕРЧЕСКАЯ ПРОФЕССИОНАЛЬНАЯ ОБРАЗОВАТЕЛЬНАЯ ОРГАНИЗАЦИЯ	19
ПО	ПРОФЕССИОНАЛЬНОГО ОБРАЗОВАНИЯ	9
ПО	ПРОФЕССИОНАЛЬНОЕ ОБРАЗОВАТЕЛЬНОЕ	6
ПО	ПРОФЕССИОНАЛЬНАЯ ОБРАЗОВАТЕЛЬНАЯ	2
ПО	ПО "ОМК	1
ПО	ПРОФЕССИОНАЛЬНОЙ ОБРАЗОВАТЕЛЬНОЙ	1
ГОУ	ГОСУДАРСТВЕННОЕ ОБРАЗОВАТЕЛЬНОЕ УЧРЕЖДЕНИЕ	9
ГОУ	ГОСУДАРСТВЕННОГО ОБРАЗОВАТЕЛЬНОГО УЧРЕЖДЕНИЯ	4
ПОО	ПРОФЕССИОНАЛЬНАЯ ОБРАЗОВАТЕЛЬНАЯ ОРГАНИЗАЦИЯ	13
ПОО	ПРОФЕССИОНАЛЬНОЙ ОБРАЗОВАТЕЛЬНОЙ ОРГАНИЗАЦИИ	1
ПОУ	ПРОФЕССИОНАЛЬНОЕ ОБРАЗОВАТЕЛЬНОЕ УЧРЕЖДЕНИЕ	12
ЧОУ	ЧАСТНОГО ОБРАЗОВАТЕЛЬНОГО УЧРЕЖДЕНИЯ	14
ГАОУ	ГОСУДАРСТВЕННОГО АВТОНОМНОГО ОБРАЗОВАТЕЛЬНОГО УЧРЕЖДЕНИЯ	13
НПО	НАЧАЛЬНОГО ПРОФЕССИОНАЛЬНОГО ОБРАЗОВАНИЯ	11
ПЭК	ПРОМЫШЛЕННО-ЭКОНОМИЧЕСКИЙ КОЛЛЕДЖ	10
УКСИВТ	УФИМСКИЙ КОЛЛЕДЖ СТАТИСТИКИ, ИНФОРМАТИКИ И ВЫЧИСЛИТЕЛЬНОЙ ТЕХНИКИ	10
АО	АМУРСКОЙ ОБЛАСТИ	1
АО	АРХАНГЕЛЬСКОЙ ОБЛАСТИ	2
АО	АСТРАХАНСКОЙ ОБЛАСТИ	3
АО	АГКПТ" (ОБЛ	1
АО	АГПК" (ОБЛ	2
ИО	ИРКУТСКОЙ ОБЛАСТИ	9
ОГБПОУ	ОБЛАСТНОЕ ГОСУДАРСТВЕННОЕ БЮДЖЕТНОЕ ПРОФЕССИОНАЛЬНОЕ ОБРАЗОВАТЕЛЬНОЕ УЧРЕЖДЕНИЕ	8
ЛО	ЛЕНИНГРАДСКОЙ ОБЛАСТИ	8
ГБ	ГОСУДАРСТВЕННОЕ БЮДЖЕТНОЕ	8
СУВУ	СПЕЦИАЛЬНОЕ УЧЕБНО-ВОСПИТАТЕЛЬНОЕ УЧРЕЖДЕНИЕ	7
ЧУ	ЧАСТНОЕ УЧРЕЖДЕНИЕ	7
МО	МОСКОВСКОЙ ОБЛАСТИ	7
ЧПГК	ЧАЙКОВСКИЙ ПРОМЫШЛЕННО-ГУМАНИТАРНЫЙ КОЛЛЕДЖ	7
ОГБОУ	ОБЛАСТНОЕ ГОСУДАРСТВЕННОЕ БЮДЖЕТНОЕ ОБРАЗОВАТЕЛЬНОЕ УЧРЕЖДЕНИЕ	7
КПМ	КОЛЛЕДЖ ПЕТЕРБУРГСКОЙ МОДЫ	7
ВСПК	ВОЛГОГРАДСКИЙ СОЦИАЛЬНО-ПЕДАГОГИЧЕСКИЙ КОЛЛЕДЖ	5
ОБОУ	ОБЛАСТНОГО БЮДЖЕТНОГО ОБРАЗОВАТЕЛЬНОГО УЧРЕЖДЕНИЯ	5
ТМК	ТИХВИНСКИЙ МЕДИЦИНСКИЙ КОЛЛЕДЖ	5
АН	АВТОНОМНАЯ НЕКОММЕРЧЕСКАЯ	5
ПЭЮК	ПОВОЛЖСКИЙ ЭКОНОМИКО-ЮРИДИЧЕСКИЙ КОЛЛЕДЖ	5
ФГБОУ	ФЕДЕРАЛЬНОГО ГОСУДАРСТВЕННОГО БЮДЖЕТНОГО ОБРАЗОВАТЕЛЬНОГО УЧРЕЖДЕНИЯ	5
ТДИИТ	ТЕХНИКУМ ДИЗАЙНА И ИНФОРМАЦИОННЫХ ТЕХНОЛОГИЙ	5
РА	РЕСПУБЛИКИ АДЫГЕЯ	2
РА	РЕСП АДЫГЕЯ	1
РА	РЕСПУБЛИКИ АЛТАЙ	1
МПТ	МАЙКОПСКИЙ ПОЛИТЕХНИЧЕСКИЙ ТЕХНИКУМ	2
МПТ	МАНТУРОВСКИЙ ПОЛИТЕХНИЧЕСКИЙ ТЕХНИКУМ	2
РБ	РЕСПУБЛИКИ БУРЯТИЯ	2
РБ	РБ БРМТИТ	1
РБ	РБ "БРМТИТ	1
БТЭИР	БРЯНСКИЙ ТЕХНИКУМ ЭНЕРГОМАШИНОСТРОЕНИЯ И РАДИОЭЛЕКТРОНИКИ	4
ВО	ВЫСШЕГО ОБРАЗОВАНИЯ	4
ПОЧУ	ПРОФЕССИОНАЛЬНОГО ОБРАЗОВАТЕЛЬНОГО ЧАСТНОГО УЧРЕЖДЕНИЯ	4
БПОУ	БЮДЖЕТНОЕ ПРОФЕССИОНАЛЬНОЕ ОБРАЗОВАТЕЛЬНОЕ УЧРЕЖДЕНИЕ	4
РО	РОСТОВСКОЙ ОБЛАСТИ	4
ГПОУ	ГОСУДАРСТВЕННОЕ ПРОФЕССИОНАЛЬНОЕ ОБРАЗОВАТЕЛЬНОЕ УЧРЕЖДЕНИЕ	4
ЯО	ЯРОСЛАВСКОЙ ОБЛАСТИ	4
СКГТК	СЕВЕРО-КУБАНСКИЙ ГУМАНИТАРНО-ТЕХНОЛОГИЧЕСКИЙ КОЛЛЕДЖ	4
НОЧУ	НЕГОСУДАРСТВЕННОГО ОБРАЗОВАТЕЛЬНОГО ЧАСТНОГО УЧРЕЖДЕНИЯ	4
АНО	АВТОНОМНОЙ НЕКОММЕРЧЕСКОЙ ОРГАНИЗАЦИИ	1
АНО	АВТОНОМНАЯ НЕКОММЕРЧЕСКАЯ ОРГАНИЗАЦИЯ	3
СТСЭУ	СТАВРОПОЛЬСКИЙ ТЕХНИКУМ СЕРВИСА, ЭКОНОМИКИ И УПРАВЛЕНИЯ	4
РД	РЕСП ДАГЕСТАН	3
РК	РЕСПУБЛИКИ КАРЕЛИЯ	3
БОУ	БЮДЖЕТНОЕ ОБРАЗОВАТЕЛЬНОЕ УЧРЕЖДЕНИЕ	3
УР	УДМУРТСКОЙ РЕСПУБЛИКИ	3
КК	КРАСНОДАРСКОГО КРАЯ	2
КК	КК КПТ	1
АГПК	АСТРАХАНСКИЙ ГОСУДАРСТВЕННЫЙ ПОЛИТЕХНИЧЕСКИЙ КОЛЛЕДЖ	3
БАТТ	БАЛАГАНСКИЙ АГРАРНО-ТЕХНОЛОГИЧЕСКИЙ ТЕХНИКУМ	3
ГПОАУ	ГОСУДАРСТВЕННОГО ПРОФЕССИОНАЛЬНОГО ОБРАЗОВАТЕЛЬНОГО АВТОНОМНОГО УЧРЕЖДЕНИЯ	3
ГООУ	ГОСУДАРСТВЕННОЕ ОБЛАСТНОЕ ОБРАЗОВАТЕЛЬНОЕ УЧРЕЖДЕНИЕ	3
ОГА	ОБЛАСТНОЕ ГОСУДАРСТВЕННОЕ АВТОНОМНОЕ	3
ФКПОУ	ФЕДЕРАЛЬНОГО КАЗЕННОГО ПРОФЕССИОНАЛЬНОГО ОБРАЗОВАТЕЛЬНОГО УЧРЕЖДЕНИЯ	3
ОКСК	ОКТЯБРЬСКИЙ КОММУНАЛЬНО-СТРОИТЕЛЬНЫЙ КОЛЛЕДЖ	2
БРМТИТ	БУРЯТСКИЙ РЕСПУБЛИКАНСКИЙ МНОГОПРОФИЛЬНЫЙ ТЕХНИКУМ ИННОВАЦИОННЫХ ТЕХНОЛОГИЙ	2
РМЭ	РЕСПУБЛИКИ МАРИЙ ЭЛ	2
РМ	РЕСПУБЛИКИ МОРДОВИЯ	2
ГАОУ	ГОСУДАРСТВЕННОЕ АВТОНОМНОЕ ОБРАЗОВАТЕЛЬНОЕ УЧРЕЖДЕНИЕ	1
ГАОУ	ГОСУДАРСТВЕННОГО АВТОНОМНОГО ОБРАЗОВАТЕЛЬНОГО УЧРЕЖДЕНИЯ	1
ПЛ	ПРОФЕССИОНАЛЬНЫЙ ЛИЦЕЙ	2
КГОУ	КРАЕВОЕ ГОСУДАРСТВЕННОЕ ОБРАЗОВАТЕЛЬНОЕ УЧРЕЖДЕНИЕ	2
КГБПОУ	КРАЕВОЕ ГОСУДАРСТВЕННОЕ БЮДЖЕТНОЕ ПРОФЕССИОНАЛЬНОЕ ОБРАЗОВАТЕЛЬНОЕ УЧРЕЖДЕНИЕ	1
КГБПОУ	КРАЕВОГО ГОСУДАРСТВЕННОГО БЮДЖЕТНОГО ПРОФЕССИОНАЛЬНОГО ОБРАЗОВАТЕЛЬНОГО УЧРЕЖДЕНИЯ	1
ГБУ	ГОСУДАРСТВЕННОГО БЮДЖЕТНОГО УЧРЕЖДЕНИЯ	2
АМК	АМУРСКИЙ МЕДИЦИНСКИЙ КОЛЛЕДЖ	1
АМК	АРХАНГЕЛЬСКИЙ МЕДИЦИНСКИЙ КОЛЛЕДЖ	1
АГКПТ	АСТРАХАНСКИЙ ГОСУДАРСТВЕННЫЙ КОЛЛЕДЖ ПРОФЕССИОНАЛЬНЫХ ТЕХНОЛОГИЙ	2
ВО	ВОРОНЕЖСКОЙ ОБЛАСТИ	1
ВО	ВОЛОГОДСКОЙ ОБЛАСТИ	1
БПТ	БРАТСКИЙ ПРОФЕССИОНАЛЬНЫЙ ТЕХНИКУМ	2
ОГОУ	ОБЛАСТНОЕ ГОСУДАРСТВЕННОЕ ОБРАЗОВАТЕЛЬНОЕ УЧРЕЖДЕНИЕ	2
ХТТ	ХИМИКО-ТЕХНОЛОГИЧЕСКИЙ ТЕХНИКУМ	2
ГБУ	ГОСУДАРСТВЕННОЕ БЮДЖЕТНОЕ УЧРЕЖДЕНИЕ	2
КО	КАЛИНИНГРАДСКОЙ ОБЛАСТИ	1
КО	КОСТРОМСКОЙ ОБЛАСТИ	1
КОГПОАУ	КИРОВСКОЕ ОБЛАСТНОЕ ГОСУДАРСТВЕННОЕ ПРОФЕССИОНАЛЬНОЕ ОБРАЗОВАТЕЛЬНОЕ АВТОНОМНОЕ УЧРЕЖДЕНИЕ	2
КОГПОБУ	КИРОВСКОЕ ОБЛАСТНОЕ ГОСУДАРСТВЕННОЕ ПРОФЕССИОНАЛЬНОЕ ОБРАЗОВАТЕЛЬНОЕ БЮДЖЕТНОЕ УЧРЕЖДЕНИЕ	2
ФГОУ	ФЕДЕРАЛЬНОЕ ГОСУДАРСТВЕННОЕ ОБРАЗОВАТЕЛЬНОЕ УЧРЕЖДЕНИЕ	2
ШКАИ	ШАХУНСКИЙ КОЛЛЕДЖ АГРАРНОЙ ИНДУСТРИИ	2
ОАПОУ	ОБЛАСТНОЕ АВТОНОМНОЕ ПРОФЕССИОНАЛЬНОЕ ОБРАЗОВАТЕЛЬНОЕ УЧРЕЖДЕНИЕ	2
БТСИИЭ	БОРОВИЧСКИЙ ТЕХНИКУМ СТРОИТЕЛЬНОЙ ИНДУСТРИИ И ЭКОНОМИКИ	2
СТСО	СЕРОВСКИЙ ТЕХНИКУМ СФЕРЫ ОБСЛУЖИВАНИЯ	2
ЧЮК	ЧЕЛЯБИНСКИЙ ЮРИДИЧЕСКИЙ КОЛЛЕДЖ	2
СШ	СРЕДНЯЯ ШКОЛА	2
АЭЮК	АНГАРСКИЙ ЭКОНОМИКО-ЮРИДИЧЕСКИЙ КОЛЛЕДЖ	2
СГМКСИП	СИБИРСКИЙ ГОСУДАРСТВЕННЫЙ МЕЖРЕГИОНАЛЬНЫЙ КОЛЛЕДЖ СТРОИТЕЛЬСТВА И ПРЕДПРИНИМАТЕЛЬСТВА	2
ФГОУ	ФЕДЕРАЛЬНОГО ГОСУДАРСТВЕННОГО ОБРАЗОВАТЕЛЬНОГО УЧРЕЖДЕНИЯ	2
ВМК	ВЫБОРГСКИЙ МЕДИЦИНСКИЙ КОЛЛЕДЖ	2
ВМТ	ВЫСОКОГОРСКИЙ МНОГОПРОФИЛЬНЫЙ ТЕХНИКУМ	2
КГОУ	КРАЕВОГО ГОСУДАРСТВЕННОГО ОБРАЗОВАТЕЛЬНОГО УЧРЕЖДЕНИЯ	2
ОАНО	ОБРАЗОВАТЕЛЬНОЙ АВТОНОМНОЙ НЕКОММЕРЧЕСКОЙ ОРГАНИЗАЦИИ	2
ЗКА	ЗАУРАЛЬСКИЙ КОЛЛЕДЖ АГРОИНЖЕНЕРИИ	1
АПОУ	АВТОНОМНОЕ ПРОФЕССИОНАЛЬНОЕ ОБРАЗОВАТЕЛЬНОЕ УЧРЕЖДЕНИЕ	1
ТТИСУ	ТЕХНИКУМ ТУРИЗМА И СФЕРЫ УСЛУГ	1
СПК	СЫКТЫВКАРСКИЙ ПЕДАГОГИЧЕСКИЙ КОЛЛЕДЖ	1
ГОУНПО	ГОСУДАРСТВЕННОЕ ОБРАЗОВАТЕЛЬНОЕ УЧРЕЖДЕНИЕ НАЧАЛЬНОГО ПРОФЕССИОНАЛЬНОГО ОБРАЗОВАНИЯ	1
СТТ	СТРОИТЕЛЬНО-ТЕХНОЛОГИЧЕСКИЙ ТЕХНИКУМ	1
АСТ	АГРАРНО-СТРОИТЕЛЬНЫЙ ТЕХНИКУМ	1
ОИТ	ОРШАНСКИЙ ИНДУСТРИАЛЬНЫЙ ТЕХНИКУМ	1
СТСУИПТ	САРАНСКИЙ ТЕХНИКУМ СФЕРЫ УСЛУГ И ПРОМЫШЛЕННЫХ ТЕХНОЛОГИЙ	1
ЧГККИ	ЧЕЧЕНСКИЙ ГОСУДАРСТВЕННЫЙ КОЛЛЕДЖ КУЛЬТУРЫ И	1
ЧГКЭ	ЧЕЧЕНСКИЙ ГОСУДАРСТВЕННЫЙ КОЛЛЕДЖ ЭКОНОМИКИ	1
ВТПП	ВОЗНЕСЕНСКИЙ ТЕХНИКУМ ПИЩЕВЫХ ПРОИЗВОДСТВ	1
КГБОУ	КРАЕВОЕ ГОСУДАРСТВЕННОЕ БЮДЖЕТНОЕ ОБРАЗОВАТЕЛЬНОЕ УЧРЕЖДЕНИЕ	1
КГБОУ	КРАЕВОГО ГОСУДАРСТВЕННОГО БЮДЖЕТНОГО ОБРАЗОВАТЕЛЬНОГО УЧРЕЖДЕНИЯ	1
КГА	КРАЕВОЕ ГОСУДАРСТВЕННОЕ АВТОНОМНОЕ	1
ГАУ	ГОСУДАРСТВЕННОЕ АВТОНОМНОЕ УЧРЕЖДЕНИЕ	1
ГАУ	ГОСУДАРСТВЕННОГО АВТОНОМНОГО УЧРЕЖДЕНИЯ	1
ВТТ	ВЛАДИМИРСКИЙ ТЕХНИКУМ ТУРИЗМА	1
ЖНТ	ЖИРНОВСКИЙ НЕФТЯНОЙ ТЕХНИКУМ	1
НМТ	НОВОУСМАНСКИЙ МНОГОПРОФИЛЬНЫЙ ТЕХНИКУМ	1
КОГОАУ	КИРОВСКОЕ ОБЛАСТНОЕ ГОСУДАРСТВЕННОЕ ОБРАЗОВАТЕЛЬНОЕ АВТОНОМНОЕ УЧРЕЖДЕНИЕ	1
НПТ	НОЛИНСКИЙ ПОЛИТЕХНИЧЕСКИЙ ТЕХНИКУМ	1
ОКПЭИП	ОМУТНИНСКИЙ КОЛЛЕДЖ ПЕДАГОГИКИ, ЭКОНОМИКИ И ПРАВА	1
ТВТ	ТЕХНИКУМ ВОДНОГО ТРАНСПОРТА	1
НИК	НИЖЕГОРОДСКИЙ ИНДУСТРИАЛЬНЫЙ КОЛЛЕДЖ	1
НКТ	НОВОСИБИРСКИЙ КООПЕРАТИВНЫЙ ТЕХНИКУМ	1
АУ	АВТОНОМНОЕ УЧРЕЖДЕНИЕ	1
СТ	СЕЛЬСКОХОЗЯЙСТВЕННЫЙ ТЕХНИКУМ	1
МИК	МЕДНОГОРСКИЙ ИНДУСТРИАЛЬНЫЙ КОЛЛЕДЖ	1
НСТ	НОВОТРОИЦКИЙ СТРОИТЕЛЬНЫЙ ТЕХНИКУМ	1
ООМК	ОРЕНБУРГСКИЙ ОБЛАСТНОЙ МЕДИЦИНСКИЙ КОЛЛЕДЖ	1
ОО	ОРЛОВСКОЙ ОБЛАСТИ	1
ОМК	ОСТРОВСКИЙ МНОГОПРОФИЛЬНЫЙ КОЛЛЕДЖ	1
КАТТ	КАРГИНСКИЙ АГРАРНО-ТЕХНОЛОГИЧЕСКИЙ ТЕХНИКУМ	1
ДПГТ	ДОНЕЦКИЙ ПРОМЫШЛЕННО-ГУМАНИТАРНЫЙ ТЕХНИКУМ	1
НПГК	НОВОЧЕРКАССКИЙ ПРОМЫШЛЕННО-ГУМАНИТАРНЫЙ КОЛЛЕДЖ	1
СТЭК	САМАРСКИЙ ТОРГОВО-ЭКОНОМИЧЕСКИЙ КОЛЛЕДЖ	1
СПЭТ	САХАЛИНСКИЙ ПРОМЫШЛЕННО-ЭКОНОМИЧЕСКИЙ ТЕХНИКУМ	1
ВДПО	ВСЕРОССИЙСКОЕ ДОБРОВОЛЬНОЕ ПОЖАРНОЕ ОБЩЕСТВО	1
БППУ	БОГДАНОВИЧСКОЕ ПРОФЕССИОНАЛЬНОЕ ПОЛИТЕХНИЧЕСКОЕ УЧИЛИЩЕ	1
КМТ	КАРПИНСКИЙ МАШИНОСТРОИТЕЛЬНЫЙ ТЕХНИКУМ	1
КАК	КРАСНОУФИМСКИЙ АГРАРНЫЙ КОЛЛЕДЖ	1
НМК	НЕВЬЯНСКИЙ МЕХАНИЧЕСКИЙ КОЛЛЕДЖ	1
ППСУ	ПЕРВОУРАЛЬСКОЕ ПРОФЕССИОНАЛЬНОЕ СТРОИТЕЛЬНОЕ УЧИЛИЩЕ	1
ТТ	ТАВДИНСКИЙ ТЕХНИКУМ	1
МОД	МЕХАНИЧЕСКОЙ ОБРАБОТКИ ДРЕВЕСИНЫ	1
СОШ	СРЕДНЯЯ ОБЩЕОБРАЗОВАТЕЛЬНАЯ ШКОЛА	1
ЕТОТС	ЕКАТЕРИНБУРГСКИЙ ТЕХНИКУМ ОТРАСЛЕВЫХ ТЕХНОЛОГИЙ И СЕРВИСА	1
ТОГАПОУ	ТАМБОВСКОЕ ОБЛАСТНОЕ ГОСУДАРСТВЕННОЕ АВТОНОМНОЕ ПРОФЕССИОНАЛЬНОЕ ОБРАЗОВАТЕЛЬНОЕ УЧРЕЖДЕНИЕ	1
БПЭК	БЕЖЕЦКИЙ ПРОМЫШЛЕННО-ЭКОНОМИЧЕСКИЙ КОЛЛЕДЖ	1
ЮПК	ЮРИДИЧЕСКИЙ ПОЛИЦЕЙСКИЙ КОЛЛЕДЖ	1
ФКП	ФЕДЕРАЛЬНОЕ КАЗЕННОЕ ПРОФЕССИОНАЛЬНОЕ	1
ГПОАУ	ГОСУДАРСТВЕННОЕ ПРОФЕССИОНАЛЬНОЕ ОБРАЗОВАТЕЛЬНОЕ АВТОНОМНОЕ УЧРЕЖДЕНИЕ	1
МКУНТ	МОСКОВСКИЙ КОЛЛЕДЖ УПРАВЛЕНИЯ И НОВЫХ ТЕХНОЛОГИЙ	1
ОГПОБУ	ОБЛАСТНОЕ ГОСУДАРСТВЕННОЕ ПРОФЕССИОНАЛЬНОЕ ОБРАЗОВАТЕЛЬНОЕ БЮДЖЕТНОЕ УЧРЕЖДЕНИЕ	1
КАПТ	КРАСНОГВАРДЕЙСКИЙ АГРАРНО-ПРОМЫШЛЕННЫЙ ТЕХНИКУМ	1
КБКС	КАБАРДИНО-БАЛКАРСКИЙ КОЛЛЕДЖ "СТРОИТЕЛЬ	1
КПТ	КРАСНОДАРСКИЙ ПОЛИТЕХНИЧЕСКИЙ ТЕХНИКУМ	1
БКЭСИ	БРЯНСКИЙ КОЛЛЕДЖ ЭКОНОМИКИ, СТАТИСТИКИ И	1
ОБПОУ	ОБЛАСТНОЕ БЮДЖЕТНОЕ ПРОФЕССИОНАЛЬНОЕ ОБРАЗОВАТЕЛЬНОЕ УЧРЕЖДЕНИЕ	1
КГПК	КУРСКИЙ ГОСУДАРСТВЕННЫЙ ПОЛИТЕХНИЧЕСКИЙ КОЛЛЕДЖ	1
ФГБУ	ФЕДЕРАЛЬНОГО ГОСУДАРСТВЕННОГО БЮДЖЕТНОГО УЧРЕЖДЕНИЯ	1
ТЭТ	ТОЛЬЯТТИНСКИЙ ЭЛЕКТРОТЕХНИЧЕСКИЙ ТЕХНИКУМ	1
ТЭПК	ТОМСКИЙ ЭКОНОМИКО-ПРОМЫШЛЕННЫЙ КОЛЛЕДЖ	1
УМТ	УЛЬКАНСКИЙ МЕЖОТРАСЛЕВОЙ ТЕХНИКУМ	1
КТСИТ	КУРГАНСКИЙ ТЕХНИКУМ СЕРВИСА И ТЕХНОЛОГИЙ	1
НОЧУ	НЕГОСУДАРСТВЕННОЕ ОБРАЗОВАТЕЛЬНОЕ ЧАСТНОЕ УЧРЕЖДЕНИЕ	1
КПИСУ	КОЛЛЕДЖ ПРЕДПРИНИМАТЕЛЬСТВА И СОЦИАЛЬНОГО УПРАВЛЕНИЯ	1
АГТ	АХТУБИНСКИЙ ГУБЕРНСКИЙ ТЕХНИКУМ	1
УПК	УВИНСКИЙ ПРОФЕССИОНАЛЬНЫЙ КОЛЛЕДЖ	1
ВСТ	ВОСТОЧНО-СИБИРСКИЙ ТЕХНИКУМ	1
ТС	ТУРИЗМА И СЕРВИСА	1
СГПК	СЫКТЫВКАРСКИЙ ГУМАНИТАРНО-ПЕДАГОГИЧЕСКИЙ КОЛЛЕДЖ	1
ОГОУ	ОБЛАСТНОГО ГОСУДАРСТВЕННОГО ОБРАЗОВАТЕЛЬНОГО УЧРЕЖДЕНИЯ	1
МАПТ	МОЗДОКСКИЙ АГРАРНО-ПРОМЫШЛЕННЫЙ ТЕХНИКУМ	1
АНПОО	АВТОНОМНАЯ НЕКОММЕРЧЕСКАЯ ПРОФЕССИОНАЛЬНАЯ ОБРАЗОВАТЕЛЬНАЯ ОРГАНИЗАЦИЯ	1
КГИМС	КОЛЛЕДЖ ГОСУДАРСТВЕННОЙ И МУНИЦИПАЛЬНОЙ СЛУЖБЫ	1
ААГ	АЛТАЙСКАЯ АКАДЕМИЯ ГОСТЕПРИИМСТВА	1
СМК	СТАВРОПОЛЬСКИЙ МНОГОПРОФИЛЬНЫЙ КОЛЛЕДЖ	1
ММК	МЕЖРЕГИОНАЛЬНЫЙ МЕДИЦИНСКИЙ КОЛЛЕДЖ	1
ДПО	ДОПОЛНИТЕЛЬНОГО ПРОФЕССИОНАЛЬНОГО ОБРАЗОВАНИЯ	1
МВЕК	МЕЖДУНАРОДНЫЙ ВОСТОЧНО-ЕВРОПЕЙСКИЙ КОЛЛЕДЖ	1
ИТ	ИНФОРМАЦИОННЫХ ТЕХНОЛОГИЙ	1
ДО	ДОПОЛНИТЕЛЬНОГО ОБРАЗОВАНИЯ	1
ППК	ПРОФЕССИОНАЛЬНО-ПЕДАГОГИЧЕСКИЙ КОЛЛЕДЖ	1