ВО	ВЫСШЕГО ОБРАЗОВАНИЯ	1495
ФГБОУ	ФЕДЕРАЛЬНОГО ГОСУДАРСТВЕННОГО БЮДЖЕТНОГО ОБРАЗОВАТЕЛЬНОГО УЧРЕЖДЕНИЯ	869
ВПО	ВЫСШЕГО ПРОФЕССИОНАЛЬНОГО ОБРАЗОВАНИЯ	375
РАН	РОССИЙСКОЙ АКАДЕМИИ НАУК	339
ИМ	ИМ. М	10
ИМ	ИССЛЕДОВАТЕЛЬСКИЙ МОРДОВСКИЙ	2
ИМ	ИНСТИТУТ МАШИНОСТРОЕНИЯ	2
ИМ	И МЕФОДИЯ	5
ИМ	ИНСТИТУТ МАТЕМАТИКИ	2
ИМ	ИНСТИТУТА МАТЕМАТИКИ	1
ИМ	И М	1
ИМ	ИМ. МАРШАЛА	5
ИМ	И. МЕНДЕЛЕЕВА	5
ИМ	ИНСТИТУТ МЕТАЛЛУРГИИ	1
ИМ	ИМ.М	1
ИМ	И. МАРЧУКА	1
ИМ	ИНСТИТУТ МАСЛОДЕЛИЯ	1
ИМ	И.М	1
ИМ	ИНСТИТУТ МАШИНОВЕДЕНИЯ	1
ИМ	ИНСТИТУТА МАШИНОВЕДЕНИЯ	1
ИМ	ИНСТИТУТ МОЛЕКУЛЯРНОЙ	1
ИМ	ИНСТИТУТ МАТЕМАТИЧЕСКИХ	1
ИМ	ИНСТИТУТ МИРОВОЙ	1
ИМ	ИНСТИТУТ МОЗГА	1
ИМ	И МИНЕРАЛОГИИ	1
ФГБОУ	ФЕДЕРАЛЬНОЕ ГОСУДАРСТВЕННОЕ БЮДЖЕТНОЕ ОБРАЗОВАТЕЛЬНОЕ УЧРЕЖДЕНИЕ	174
ФГБОУ	ФЕДЕРАЛЬНОГО ГОСУДАРСТВЕННОГО БЮДЖЕТНОГО ОБРАЗОВАТЕЛЬНОГО УЧРЕЖДЕНИЯ	5
ИЦ	ИССЛЕДОВАТЕЛЬСКИЙ ЦЕНТР	155
ИЦ	ИССЛЕДОВАТЕЛЬСКИЙ "ЦЕНТР	2
ФГАОУ	ФЕДЕРАЛЬНОГО ГОСУДАРСТВЕННОГО АВТОНОМНОГО ОБРАЗОВАТЕЛЬНОГО УЧРЕЖДЕНИЯ	132
ФГАОУ	ФЕДЕРАЛЬНОЕ ГОСУДАРСТВЕННОЕ АВТОНОМНОЕ ОБРАЗОВАТЕЛЬНОЕ УЧРЕЖДЕНИЕ	12
ФГБУ	ФЕДЕРАЛЬНОГО ГОСУДАРСТВЕННОГО БЮДЖЕТНОГО УЧРЕЖДЕНИЯ	143
ФГБНУ	ФЕДЕРАЛЬНОГО ГОСУДАРСТВЕННОГО БЮДЖЕТНОГО НАУЧНОГО УЧРЕЖДЕНИЯ	141
НОЧУ	НЕГОСУДАРСТВЕННОГО ОБРАЗОВАТЕЛЬНОГО ЧАСТНОГО УЧРЕЖДЕНИЯ	119
НОУ	НЕГОСУДАРСТВЕННОГО ОБРАЗОВАТЕЛЬНОГО УЧРЕЖДЕНИЯ	19
НОУ	НЕГОСУДАРСТВЕННОЕ ОБРАЗОВАТЕЛЬНОЕ УЧРЕЖДЕНИЕ	84
АНО	АВТОНОМНАЯ НЕКОММЕРЧЕСКАЯ ОРГАНИЗАЦИЯ	30
АНО	АВТОНОМНОЙ НЕКОММЕРЧЕСКОЙ ОРГАНИЗАЦИИ	57
СО	СИБИРСКОГО ОТДЕЛЕНИЯ	76
СО	СИБИРСКОЕ ОТДЕЛЕНИЕ	2
ГПС	ГОСУДАРСТВЕННОЙ ПРОТИВОПОЖАРНОЙ СЛУЖБЫ	76
УЛ	УЛ ЛОМОНОСОВА	1
УЛ	УЛ ЛЕНИНА	2
УЛ	УЛ ЛУНАЧАРСКОГО	1
ФГОБУ	ФЕДЕРАЛЬНОГО ГОСУДАРСТВЕННОГО ОБРАЗОВАТЕЛЬНОГО БЮДЖЕТНОГО УЧРЕЖДЕНИЯ	27
ФГОБУ	ФЕДЕРАЛЬНОЕ ГОСУДАРСТВЕННОЕ ОБРАЗОВАТЕЛЬНОЕ БЮДЖЕТНОЕ УЧРЕЖДЕНИЕ	17
ФГОУ	ФЕДЕРАЛЬНОГО ГОСУДАРСТВЕННОГО ОБРАЗОВАТЕЛЬНОГО УЧРЕЖДЕНИЯ	5
ФГОУ	ФЕДЕРАЛЬНОЕ ГОСУДАРСТВЕННОЕ ОБРАЗОВАТЕЛЬНОЕ УЧРЕЖДЕНИЕ	35
УРАО	УНИВЕРСИТЕТ РОССИЙСКОЙ АКАДЕМИИ ОБРАЗОВАНИЯ	40
АО	АКЦИОНЕРНОЕ ОБЩЕСТВО	37
ЧОУ	ЧАСТНОГО ОБРАЗОВАТЕЛЬНОГО УЧРЕЖДЕНИЯ	36
ЧОУВО	ЧАСТНОЕ ОБРАЗОВАТЕЛЬНОЕ УЧРЕЖДЕНИЕ ВЫСШЕГО ОБРАЗОВАНИЯ	35
РГТЭУ	РОССИЙСКИЙ ГОСУДАРСТВЕННЫЙ ТОРГОВО-ЭКОНОМИЧЕСКИЙ УНИВЕРСИТЕТ	28
МПСУ	МОСКОВСКИЙ ПСИХОЛОГО-СОЦИАЛЬНЫЙ УНИВЕРСИТЕТ	28
ЮРГУЭС	ЮЖНО-РОССИЙСКИЙ ГОСУДАРСТВЕННЫЙ УНИВЕРСИТЕТ ЭКОНОМИКИ И СЕРВИСА	26
ЧОУ	ЧАСТНОЕ ОБРАЗОВАТЕЛЬНОЕ УЧРЕЖДЕНИЕ	21
ГБУЗ	ГОСУДАРСТВЕННОЕ БЮДЖЕТНОЕ УЧРЕЖДЕНИЕ ЗДРАВООХРАНЕНИЯ	21
РАО	РОССИЙСКОЙ АКАДЕМИИ ОБРАЗОВАНИЯ	20
МГОУ	МОСКОВСКИЙ ГОСУДАРСТВЕННЫЙ ОТКРЫТЫЙ УНИВЕРСИТЕТ	18
ГУМФ	ГОСУДАРСТВЕННЫЙ УНИВЕРСИТЕТ МИНИСТЕРСТВА ФИНАНСОВ	17
МОУ	МУНИЦИПАЛЬНОЕ ОБРАЗОВАТЕЛЬНОЕ УЧРЕЖДЕНИЕ	16
ЮУПИ	ЮЖНО-УРАЛЬСКИЙ ПРОФЕССИОНАЛЬНЫЙ ИНСТИТУТ	16
МОСА	МОСКОВСКАЯ ОТКРЫТАЯ СОЦИАЛЬНАЯ АКАДЕМИЯ	16
ФГАУ	ФЕДЕРАЛЬНОГО ГОСУДАРСТВЕННОГО АВТОНОМНОГО УЧРЕЖДЕНИЯ	15
ГКОУ	ГОСУДАРСТВЕННОГО КАЗЕННОГО ОБРАЗОВАТЕЛЬНОГО УЧРЕЖДЕНИЯ	15
ПКБ	ПСИХИАТРИЧЕСКАЯ КЛИНИЧЕСКАЯ БОЛЬНИЦА	14
МИГУП	МОСКОВСКИЙ ИНСТИТУТ ГОСУДАРСТВЕННОГО УПРАВЛЕНИЯ И ПРАВА	14
СЗАГС	СЕВЕРО-ЗАПАДНАЯ АКАДЕМИЯ ГОСУДАРСТВЕННОЙ СЛУЖБЫ	13
ДО	ДОПОЛНИТЕЛЬНОГО ОБРАЗОВАНИЯ	2
ДО	ДАЛЬНЕВОСТОЧНОГО ОТДЕЛЕНИЯ	10
СГСЭУ	САРАТОВСКИЙ ГОСУДАРСТВЕННЫЙ СОЦИАЛЬНО-ЭКОНОМИЧЕСКИЙ УНИВЕРСИТЕТ	12
РФ	РОССИЙСКОЙ ФЕДЕРАЦИИ	12
МГАВТ	МОСКОВСКАЯ ГОСУДАРСТВЕННАЯ АКАДЕМИЯ ВОДНОГО ТРАНСПОРТА	12
НОЧУ	НЕГОСУДАРСТВЕННОЕ ОБРАЗОВАТЕЛЬНОЕ ЧАСТНОЕ УЧРЕЖДЕНИЕ	12
НАЧОУВО	НЕГОСУДАРСТВЕННОЕ АККРЕДИТОВАННОЕ ЧАСТНОЕ ОБРАЗОВАТЕЛЬНОЕ УЧРЕЖДЕНИЕ ВЫСШЕГО ОБРАЗОВАНИЯ	11
ГБУ	ГОСУДАРСТВЕННОГО БЮДЖЕТНОГО УЧРЕЖДЕНИЯ	11
МГУПИ	МОСКОВСКИЙ ГОСУДАРСТВЕННЫЙ УНИВЕРСИТЕТ ПРИБОРОСТРОЕНИЯ И	11
ГБОУ	ГОСУДАРСТВЕННОГО БЮДЖЕТНОГО ОБРАЗОВАТЕЛЬНОГО УЧРЕЖДЕНИЯ	10
СКАГС	СЕВЕРО-КАВКАЗСКАЯ АКАДЕМИЯ ГОСУДАРСТВЕННОЙ СЛУЖБЫ	10
ООВО	ОБРАЗОВАТЕЛЬНАЯ ОРГАНИЗАЦИЯ ВЫСШЕГО ОБРАЗОВАНИЯ	10
ОУ	ОБРАЗОВАТЕЛЬНОЕ УЧРЕЖДЕНИЕ	9
ОУ	ОБЛ УЛЬЯНОВСКАЯ	1
СКИ	САРАНСКИЙ КООПЕРАТИВНЫЙ ИНСТИТУТ	10
МСГИ	МОСКОВСКИЙ СОЦИАЛЬНО-ГУМАНИТАРНЫЙ ИНСТИТУТ	10
МИПП	МОСКОВСКИЙ ИНСТИТУТ ПРЕДПРИНИМАТЕЛЬСТВА И ПРАВА	9
ГАОУ	ГОСУДАРСТВЕННОГО АВТОНОМНОГО ОБРАЗОВАТЕЛЬНОГО УЧРЕЖДЕНИЯ	8
ГОУ	ГОСУДАРСТВЕННОГО ОБРАЗОВАТЕЛЬНОГО УЧРЕЖДЕНИЯ	5
ГОУ	ГОСУДАРСТВЕННОЕ ОБРАЗОВАТЕЛЬНОЕ УЧРЕЖДЕНИЕ	3
СГУГИТ	СИБИРСКИЙ ГОСУДАРСТВЕННЫЙ УНИВЕРСИТЕТ ГЕОСИСТЕМ И ТЕХНОЛОГИЙ	8
ФГОУВПО	ФЕДЕРАЛЬНОЕ ГОСУДАРСТВЕННОЕ ОБРАЗОВАТЕЛЬНОЕ УЧРЕЖДЕНИЕ ВЫСШЕГО ПРОФЕССИОНАЛЬНОГО ОБРАЗОВАНИЯ	8
ПАГС	ПОВОЛЖСКАЯ АКАДЕМИЯ ГОСУДАРСТВЕННОЙ СЛУЖБЫ	8
ИДК	ИНСТИТУТ ДЕЛОВОЙ КАРЬЕРЫ	8
АМИ	АКАДЕМИЧЕСКИЙ МЕЖДУНАРОДНЫЙ ИНСТИТУТ	8
ЧР	ЧР (РЕСП	3
ГБОУ	ГОСУДАРСТВЕННОЕ БЮДЖЕТНОЕ ОБРАЗОВАТЕЛЬНОЕ УЧРЕЖДЕНИЕ	6
МОУ	МУНИЦИПАЛЬНОГО ОБРАЗОВАТЕЛЬНОГО УЧРЕЖДЕНИЯ	7
МГТУ	МОСКОВСКИЙ ГОСУДАРСТВЕННЫЙ ТЕХНИЧЕСКИЙ УНИВЕРСИТЕТ	7
ГА	ГРАЖДАНСКОЙ АВИАЦИИ	7
ДПО	ДОПОЛНИТЕЛЬНОГО ПРОФЕССИОНАЛЬНОГО ОБРАЗОВАНИЯ	7
ФГУП	ФЕДЕРАЛЬНОЕ ГОСУДАРСТВЕННОЕ УНИТАРНОЕ ПРЕДПРИЯТИЕ	7
ОАНО	ОБРАЗОВАТЕЛЬНОЙ АВТОНОМНОЙ НЕКОММЕРЧЕСКОЙ ОРГАНИЗАЦИИ	7
ИДНК	ИНСТИТУТ ДРУЖБЫ НАРОДОВ КАВКАЗА	6
САПЭУ	СИБИРСКАЯ АКАДЕМИЯ ПРАВА, ЭКОНОМИКИ И УПРАВЛЕНИЯ	6
ЮФУ	ЮЖНЫЙ ФЕДЕРАЛЬНЫЙ УНИВЕРСИТЕТ	6
ФГБУ	ФЕДЕРАЛЬНОЕ ГОСУДАРСТВЕННОЕ БЮДЖЕТНОЕ УЧРЕЖДЕНИЕ	6
РАНХИГС	РОССИЙСКАЯ АКАДЕМИЯ НАРОДНОГО ХОЗЯЙСТВА И ГОСУДАРСТВЕННОЙ СЛУЖБЫ	6
НПО	НАУЧНО-ПРОИЗВОДСТВЕННОЕ ОБЪЕДИНЕНИЕ	5
РМАТ	РОССИЙСКАЯ МЕЖДУНАРОДНАЯ АКАДЕМИЯ ТУРИЗМА	5
ОРАГС	ОРЛОВСКАЯ РЕГИОНАЛЬНАЯ АКАДЕМИЯ ГОСУДАРСТВЕННОЙ СЛУЖБЫ	5
ЦНИИП	ЦЕНТРАЛЬНЫЙ НАУЧНО-ИССЛЕДОВАТЕЛЬСКИЙ И ПРОЕКТНЫЙ	5
НИЦ	НАЦИОНАЛЬНОГО ИССЛЕДОВАТЕЛЬСКОГО ЦЕНТРА	5
МАИ	МОСКОВСКИЙ АВИАЦИОННЫЙ ИНСТИТУТ	5
ЦНИИ	ЦЕНТРАЛЬНЫЙ НАУЧНО-ИССЛЕДОВАТЕЛЬСКИЙ ИНСТИТУТ	5
ИПСА	ИВАНОВСКАЯ ПОЖАРНО-СПАСАТЕЛЬНАЯ АКАДЕМИЯ	5
СГПИ	СТАВРОПОЛЬСКИЙ ГОСУДАРСТВЕННЫЙ ПЕДАГОГИЧЕСКИЙ ИНСТИТУТ	4
КГИ	КРЕСТЬЯНСКИЙ ГОСУДАРСТВЕННЫЙ ИНСТИТУТ	4
ПАО	ПУБЛИЧНОЕ АКЦИОНЕРНОЕ ОБЩЕСТВО	4
РГСУ	РОСТОВСКИЙ ГОСУДАРСТВЕННЫЙ СТРОИТЕЛЬНЫЙ УНИВЕРСИТЕТ	4
ИПИ	ИНСТИТУТ ПРОФЕССИОНАЛЬНЫХ ИННОВАЦИЙ	4
НОЧУВПО	НЕГОСУДАРСТВЕННОЕ ОБРАЗОВАТЕЛЬНОЕ ЧАСТНОЕ УЧРЕЖДЕНИЕ ВЫСШЕГО ПРОФЕССИОНАЛЬНОГО ОБРАЗОВАНИЯ	4
АПИ	АКАДЕМИЧЕСКИЙ ПРАВОВОЙ ИНСТИТУТ	4
НПП	НАУЧНО-ПРОИЗВОДСТВЕННОЕ ПРЕДПРИЯТИЕ	4
ВДО	ВЫСШЕГО И ДОПОЛНИТЕЛЬНОГО ОБРАЗОВАНИЯ	4
БГИ	БАЙКАЛЬСКИЙ ГУМАНИТАРНЫЙ ИНСТИТУТ	4
СПСА	СИБИРСКАЯ ПОЖАРНО-СПАСАТЕЛЬНАЯ АКАДЕМИЯ	4
ЛО	ЛЕНИНГРАДСКОЙ ОБЛАСТИ	3
ВВАГС	ВОЛГО-ВЯТСКАЯ АКАДЕМИЯ ГОСУДАРСТВЕННОЙ СЛУЖБЫ	3
ПГТ	П.Г.Т	3
ЧУ	ЧАСТНОЕ УЧРЕЖДЕНИЕ	3
ИГА	ИНСТИТУТ ГОСУДАРСТВЕННОГО АДМИНИСТРИРОВАНИЯ	3
ГНЦ	ГОСУДАРСТВЕННЫЙ НАУЧНЫЙ ЦЕНТР	2
ГНЦ	ГОСУДАРСТВЕННОГО НАУЧНОГО ЦЕНТРА	1
НПЦ	НАУЧНО-ПРАКТИЧЕСКИЙ ЦЕНТР	3
ПЗДП	ПСИХИЧЕСКОГО ЗДОРОВЬЯ ДЕТЕЙ И ПОДРОСТКОВ	3
ИФЗ	ИНСТИТУТ ФИЗИКИ ЗЕМЛИ	3
ГМУ	ГОСУДАРСТВЕННЫЙ МЕДИЦИНСКИЙ УНИВЕРСИТЕТ	2
ВСИЭП	ВОСТОЧНО-СИБИРСКИЙ ИНСТИТУТ ЭКОНОМИКИ И ПРАВА	2
СПГИ	СЕРГИЕВО-ПОСАДСКИЙ ГУМАНИТАРНЫЙ ИНСТИТУТ	2
НКИ	НИЖЕГОРОДСКИЙ КОММЕРЧЕСКИЙ ИНСТИТУТ	2
РГЭУ	РОСТОВСКИЙ ГОСУДАРСТВЕННЫЙ ЭКОНОМИЧЕСКИЙ УНИВЕРСИТЕТ	2
УИЭУИП	УРАЛЬСКИЙ ИНСТИТУТ ЭКОНОМИКИ, УПРАВЛЕНИЯ И ПРАВА	2
ИГПИ	ИШИМСКИЙ ГОСУДАРСТВЕННЫЙ ПЕДАГОГИЧЕСКИЙ ИНСТИТУТ	2
ТГСПА	ТОБОЛЬСКАЯ ГОСУДАРСТВЕННАЯ СОЦИАЛЬНО-ПЕДАГОГИЧЕСКАЯ АКАДЕМИЯ	2
НП	НЕКОММЕРЧЕСКОЕ ПАРТНЕРСТВО	2
ИМСГС	ИНСТИТУТ МЕЖДУНАРОДНЫХ СОЦИАЛЬНО-ГУМАНИТАРНЫХ СВЯЗЕЙ	2
МГУПБ	МОСКОВСКИЙ ГОСУДАРСТВЕННЫЙ УНИВЕРСИТЕТ ПРИКЛАДНОЙ БИОТЕХНОЛОГИИ	2
ОЧУ	ОБРАЗОВАТЕЛЬНОГО ЧАСТНОГО УЧРЕЖДЕНИЯ	2
РАГС	РОССИЙСКАЯ АКАДЕМИЯ ГОСУДАРСТВЕННОЙ СЛУЖБЫ	2
РУДН	РОССИЙСКИЙ УНИВЕРСИТЕТ ДРУЖБЫ НАРОДОВ	2
ИМБП	ИНСТИТУТ МЕДИКО-БИОЛОГИЧЕСКИХ ПРОБЛЕМ	1
ИМБП	ИНСТИТУТА МЕДИКО-БИОЛОГИЧЕСКИХ ПРОБЛЕМ	1
БОУ	БЮДЖЕТНОГО ОБРАЗОВАТЕЛЬНОГО УЧРЕЖДЕНИЯ	2
ЦНИИХМ	ЦЕНТРАЛЬНЫЙ НАУЧНО-ИССЛЕДОВАТЕЛЬСКИЙ ИНСТИТУТ ХИМИИ И МЕХАНИКИ	2
ИКИП	ИНСТИТУТ КОММЕРЦИИ И ПРАВА	2
КМ	КОНСТРУКЦИОННЫХ МАТЕРИАЛОВ	2
МНПЦ	МОСКОВСКИЙ НАУЧНО-ПРАКТИЧЕСКИЙ ЦЕНТР	2
СГЛА	СЛАВЯНО-ГРЕКО-ЛАТИНСКАЯ АКАДЕМИЯ	2
ОАНО	ОБРАЗОВАТЕЛЬНАЯ АВТОНОМНАЯ НЕКОММЕРЧЕСКАЯ ОРГАНИЗАЦИЯ	2
МГТА	МЕЖДУНАРОДНАЯ ГУМАНИТАРНО-ТЕХНИЧЕСКАЯ АКАДЕМИЯ	1
САО	СПЕЦИАЛЬНАЯ АСТРОФИЗИЧЕСКАЯ ОБСЕРВАТОРИЯ	1
СВФУ	СЕВЕРО-ВОСТОЧНЫЙ ФЕДЕРАЛЬНЫЙ УНИВЕРСИТЕТ	1
НЧОУ	НЕГОСУДАРСТВЕННОГО ЧАСТНОГО ОБРАЗОВАТЕЛЬНОГО УЧРЕЖДЕНИЯ	1
НЧОУ	НЕКОММЕРЧЕСКОЕ ЧАСТНОЕ ОБРАЗОВАТЕЛЬНОЕ УЧРЕЖДЕНИЕ	1
НИЭУП	НЕВИННОМЫССКИЙ ИНСТИТУТ ЭКОНОМИКИ, УПРАВЛЕНИЯ И ПРАВА	1
ИЭИ	ИНСТИТУТ ЭКОНОМИЧЕСКИХ ИССЛЕДОВАНИЙ	1
БИЭИ	БЕЛГОРОДСКИЙ ИНЖЕНЕРНО-ЭКОНОМИЧЕСКИЙ ИНСТИТУТ	1
БИУБ	БРЯНСКИЙ ИНСТИТУТ УПРАВЛЕНИЯ И БИЗНЕСА	1
ГАОУ	ГОСУДАРСТВЕННОЕ АВТОНОМНОЕ ОБРАЗОВАТЕЛЬНОЕ УЧРЕЖДЕНИЕ	1
ЛГУ	ЛЕНИНГРАДСКИЙ ГОСУДАРСТВЕННЫЙ УНИВЕРСИТЕТ	1
РКК	РАКЕТНО-КОСМИЧЕСКАЯ КОРПОРАЦИЯ	1
РФЯЦ	РОССИЙСКИЙ ФЕДЕРАЛЬНЫЙ ЯДЕРНЫЙ ЦЕНТР	1
ВНИИЭФ	ВСЕРОССИЙСКИЙ НАУЧНО-ИССЛЕДОВАТЕЛЬСКИЙ ИНСТИТУТ ЭКСПЕРИМЕНТАЛЬНОЙ ФИЗИКИ	1
СИБИТ	СИБИРСКИЙ ИНСТИТУТ БИЗНЕСА И ИНФОРМАЦИОННЫХ ТЕХНОЛОГИЙ	1
РМИЭУ	РОСТОВСКИЙ МЕЖДУНАРОДНЫЙ ИНСТИТУТ ЭКОНОМИКИ И УПРАВЛЕНИЯ	1
ТГТУ	ТАМБОВСКИЙ ГОСУДАРСТВЕННЫЙ ТЕХНИЧЕСКИЙ УНИВЕРСИТЕТ	1
МИДИС	МЕЖДУНАРОДНЫЙ ИНСТИТУТ ДИЗАЙНА И СЕРВИСА	1
ФГБНУ	ФЕДЕРАЛЬНОЕ ГОСУДАРСТВЕННОЕ БЮДЖЕТНОЕ НАУЧНОЕ УЧРЕЖДЕНИЕ	1
ЦНИИТ	ЦЕНТРАЛЬНЫЙ НАУЧНО-ИССЛЕДОВАТЕЛЬСКИЙ ИНСТИТУТ ТУБЕРКУЛЕЗА	1
РХТУ	РОССИЙСКИЙ ХИМИКО-ТЕХНОЛОГИЧЕСКИЙ УНИВЕРСИТЕТ	1
МАОК	МЕЖДУНАРОДНАЯ АКАДЕМИЯ ОЦЕНКИ И КОНСАЛТИНГА	1
ЦМЭИ	ЦЕНТР МЕДИКО-ЭКОЛОГИЧЕСКИХ ИССЛЕДОВАНИЙ	1
КПИ	КОЛЛЕДЖ ПРИКЛАДНОГО ИСКУССТВА	1
МГХПА	МОСКОВСКАЯ ГОСУДАРСТВЕННАЯ ХУДОЖЕСТВЕННО-ПРОМЫШЛЕННАЯ АКАДЕМИЯ	1
ГМА	ГОСУДАРСТВЕННАЯ МОРСКАЯ АКАДЕМИЯ	1
БГТУ	БАЛТИЙСКИЙ ГОСУДАРСТВЕННЫЙ ТЕХНИЧЕСКИЙ УНИВЕРСИТЕТ	1
ВИБ	ВЛАДИМИРСКИЙ ИНСТИТУТ БИЗНЕСА	1
ИГД	ИНСТИТУТ ГОРНОГО ДЕЛА	1
НОУВПО	НЕГОСУДАРСТВЕННОЕ ОБРАЗОВАТЕЛЬНОЕ УЧРЕЖДЕНИЕ ВЫСШЕГО ПРОФЕССИОНАЛЬНОГО ОБРАЗОВАНИЯ	1
ВГНА	ВСЕРОССИЙСКАЯ ГОСУДАРСТВЕННАЯ НАЛОГОВАЯ АКАДЕМИЯ	1
ИГП	ИНСТИТУТ ГОСУДАРСТВА И ПРАВА	1
НИКИО	НАУЧНО-ИССЛЕДОВАТЕЛЬСКИЙ КЛИНИЧЕСКИЙ ИНСТИТУТ ОТОРИНОЛАРИНГОЛОГИИ	1
МАБИУ	МЕЖДУНАРОДНАЯ АКАДЕМИЯ БИЗНЕСА И УПРАВЛЕНИЯ	1
НИИФ	НАУЧНО-ИССЛЕДОВАТЕЛЬСКИЙ ИНСТИТУТ ФТИЗИОПУЛЬМОНОЛОГИИ	1
ФБУН	ФЕДЕРАЛЬНОЕ БЮДЖЕТНОЕ УЧРЕЖДЕНИЕ НАУКИ	1
ПМБ	ПРИКЛАДНОЙ МИКРОБИОЛОГИИ И БИОТЕХНОЛОГИИ	1
СИ	САМАРСКИЙ ИНСТИТУТ	1
ВШПП	ВЫСШАЯ ШКОЛА ПРИВАТИЗАЦИИ И ПРЕДПРИНИМАТЕЛЬСТВА	1
ДГИ	ДАГЕСТАНСКИЙ ГУМАНИТАРНЫЙ ИНСТИТУТ	1
ФАУ	ФЕДЕРАЛЬНОЕ АВТОНОМНОЕ УЧРЕЖДЕНИЕ	1