АО	АКЦИОНЕРНОЕ ОБЩЕСТВО	893
АО	АКЦИОНЕРНОГО ОБЩЕСТВА	12
АО	АСТРАХАНСКОЙ ОБЛАСТИ	3
АО	АВТОНОМНЫЙ ОКРУГ	4
ДПО	ДОПОЛНИТЕЛЬНОГО ПРОФЕССИОНАЛЬНОГО ОБРАЗОВАНИЯ	816
ДОСААФ	ДОБРОВОЛЬНОЕ ОБЩЕСТВО СОДЕЙСТВИЯ АРМИИ, АВИАЦИИ И ФЛОТУ	756
ДОСААФ	ДОБРОВОЛЬНОЕ ОБЩЕСТВО СОДЕЙСТВИЯ АРМИИ,АВИАЦИИ И ФЛОТУ	29
ДО	ДОПОЛНИТЕЛЬНОГО ОБРАЗОВАНИЯ	570
ДО	ДУБЪЯЗСКОЕ ОТДЕЛЕНИЕ	1
ДО	ДАЛЬНЕВОСТОЧНОГО ОТДЕЛЕНИЯ	8
ФГБУ	ФЕДЕРАЛЬНОГО ГОСУДАРСТВЕННОГО БЮДЖЕТНОГО УЧРЕЖДЕНИЯ	184
ФГБУ	ФЕДЕРАЛЬНОЕ ГОСУДАРСТВЕННОЕ БЮДЖЕТНОЕ УЧРЕЖДЕНИЕ	50
АНО	АВТОНОМНАЯ НЕКОММЕРЧЕСКАЯ ОРГАНИЗАЦИЯ	147
АНО	АВТОНОМНОЙ НЕКОММЕРЧЕСКОЙ ОРГАНИЗАЦИИ	84
МБУ	МУНИЦИПАЛЬНОЕ БЮДЖЕТНОЕ УЧРЕЖДЕНИЕ	50
МБУ	МУНИЦИПАЛЬНОГО БЮДЖЕТНОГО УЧРЕЖДЕНИЯ	169
ПАО	ПУБЛИЧНОЕ АКЦИОНЕРНОЕ ОБЩЕСТВО	194
ДОМ	ДВУХ ОБЪЕКТОВ (МУЗЕЙ	2
ДОМ	ДОПОЛНИТЕЛЬНОГО ОБРАЗОВАНИЯ "МАЛОАРХАНГЕЛЬСКИЙ	1
ФКПОУ	ФЕДЕРАЛЬНОГО КАЗЕННОГО ПРОФЕССИОНАЛЬНОГО ОБРАЗОВАТЕЛЬНОГО УЧРЕЖДЕНИЯ	141
ВПО	ВЫСШЕГО ПРОФЕССИОНАЛЬНОГО ОБРАЗОВАНИЯ	141
МБОУ	МУНИЦИПАЛЬНОГО БЮДЖЕТНОГО ОБРАЗОВАТЕЛЬНОГО УЧРЕЖДЕНИЯ	64
МБОУ	МУНИЦИПАЛЬНОМ БЮДЖЕТНОМ ОБЩЕОБРАЗОВАТЕЛЬНОМ УЧРЕЖДЕНИИ	2
МБОУ	МУНИЦИПАЛЬНОЕ БЮДЖЕТНОЕ ОБРАЗОВАТЕЛЬНОЕ УЧРЕЖДЕНИЕ	18
МБОУ	МУНИЦИПАЛЬНОГО БЮДЖЕТНОГО ОБЩЕОБРАЗОВАТЕЛЬНОГО УЧРЕЖДЕНИЯ	11
МБОУ	МУНИЦИПАЛЬНОЕ БЮДЖЕТНОЕ ОБЩЕОБРАЗОВАТЕЛЬНОЕ УЧРЕЖДЕНИЕ	37
НОУ	НЕГОСУДАРСТВЕННОГО ОБРАЗОВАТЕЛЬНОГО УЧРЕЖДЕНИЯ	16
НОУ	НЕГОСУДАРСТВЕННОЕ ОБРАЗОВАТЕЛЬНОЕ УЧРЕЖДЕНИЕ	109
ЧОУ	ЧАСТНОЕ ОБРАЗОВАТЕЛЬНОЕ УЧРЕЖДЕНИЕ	60
ЧОУ	ЧАСТНОГО ОБРАЗОВАТЕЛЬНОГО УЧРЕЖДЕНИЯ	57
ЧОУ	ЧАСТНОГО ОБЩЕОБРАЗОВАТЕЛЬНОГО УЧРЕЖДЕНИЯ	2
ЧОУ	ЧАСТНОЕ ОБЩЕОБРАЗОВАТЕЛЬНОЕ УЧРЕЖДЕНИЕ	1
ДШИ	ДЕТСКАЯ ШКОЛА ИСКУССТВ	106
ВДПО	ВСЕРОССИЙСКОЕ ДОБРОВОЛЬНОЕ ПОЖАРНОЕ ОБЩЕСТВО	95
РАН	РОССИЙСКОЙ АКАДЕМИИ НАУК	90
ГБУ	ГОСУДАРСТВЕННОГО БЮДЖЕТНОГО УЧРЕЖДЕНИЯ	56
ГБУ	ГОСУДАРСТВЕННОЕ БЮДЖЕТНОЕ УЧРЕЖДЕНИЕ	25
НОШ	НАЧАЛЬНАЯ ОБЩЕОБРАЗОВАТЕЛЬНАЯ ШКОЛА	65
ГПС	ГОСУДАРСТВЕННОЙ ПРОТИВОПОЖАРНОЙ СЛУЖБЫ	55
ФКП	ФЕДЕРАЛЬНОЕ КАЗЕННОЕ ПРЕДПРИЯТИЕ	5
ФКП	ФЕДЕРАЛЬНАЯ КАДАСТРОВАЯ ПАЛАТА	1
ФКП	ФЕДЕРАЛЬНОЕ КАЗЕННОЕ ПРОФЕССИОНАЛЬНОЕ	54
ФКП	ФЕДЕРАЛЬНОГО КАЗЕННОГО ПРОФЕССИОНАЛЬНОГО	4
ООШ	ОСНОВНАЯ ОБЩЕОБРАЗОВАТЕЛЬНАЯ ШКОЛА	63
СОШ	СРЕДНЯЯ ОБЩЕОБРАЗОВАТЕЛЬНАЯ ШКОЛА	51
СОШ	СМЕННАЯ) ОБЩЕОБРАЗОВАТЕЛЬНАЯ ШКОЛА	3
СПО	СРЕДНЕГО ПРОФЕССИОНАЛЬНОГО ОБРАЗОВАНИЯ	55
ИЦ	ИССЛЕДОВАТЕЛЬСКИЙ ЦЕНТР	54
МБУДО	МУНИЦИПАЛЬНОЕ БЮДЖЕТНОЕ УЧРЕЖДЕНИЕ ДОПОЛНИТЕЛЬНОГО ОБРАЗОВАНИЯ	54
ФГАОУ	ФЕДЕРАЛЬНОГО ГОСУДАРСТВЕННОГО АВТОНОМНОГО ОБРАЗОВАТЕЛЬНОГО УЧРЕЖДЕНИЯ	37
ФГАОУ	ФЕДЕРАЛЬНОЕ ГОСУДАРСТВЕННОЕ АВТОНОМНОЕ ОБРАЗОВАТЕЛЬНОЕ УЧРЕЖДЕНИЕ	17
НА	НА АМУРЕ	1
НА	НА АВТОТРАНСПОРТЕ	1
НА	НА АВТОМОБИЛЬНОМ	1
НА	НА АТОМНЫХ	1
НА	НОВОВОРОНЕЖСКОЙ АТОМНОЙ	1
ФГБНУ	ФЕДЕРАЛЬНОГО ГОСУДАРСТВЕННОГО БЮДЖЕТНОГО НАУЧНОГО УЧРЕЖДЕНИЯ	47
ГАУ	ГОСУДАРСТВЕННОГО АВТОНОМНОГО УЧРЕЖДЕНИЯ	33
ГАУ	ГОСУДАРСТВЕННОЕ АВТОНОМНОЕ УЧРЕЖДЕНИЕ	14
ЦЛАТИ	ЦЕНТР ЛАБОРАТОРНОГО АНАЛИЗА И ТЕХНИЧЕСКИХ ИЗМЕРЕНИЙ	46
ГБОУ	ГОСУДАРСТВЕННОГО БЮДЖЕТНОГО ОБРАЗОВАТЕЛЬНОГО УЧРЕЖДЕНИЯ	10
ГБОУ	ГОСУДАРСТВЕННОЕ БЮДЖЕТНОЕ ОБРАЗОВАТЕЛЬНОЕ УЧРЕЖДЕНИЕ	30
ГБОУ	ГОСУДАРСТВЕННОЕ БЮДЖЕТНОЕ ОБЩЕОБРАЗОВАТЕЛЬНОЕ УЧРЕЖДЕНИЕ	2
ФГБОУ	ФЕДЕРАЛЬНОГО ГОСУДАРСТВЕННОГО БЮДЖЕТНОГО ОБРАЗОВАТЕЛЬНОГО УЧРЕЖДЕНИЯ	19
ФГБОУ	ФЕДЕРАЛЬНОЕ ГОСУДАРСТВЕННОЕ БЮДЖЕТНОЕ ОБРАЗОВАТЕЛЬНОЕ УЧРЕЖДЕНИЕ	21
ЛПУМГ	ЛИНЕЙНОЕ ПРОИЗВОДСТВЕННОЕ УПРАВЛЕНИЕ МАГИСТРАЛЬНЫХ ГАЗОПРОВОДОВ	26
ФГУП	ФЕДЕРАЛЬНОЕ ГОСУДАРСТВЕННОЕ УНИТАРНОЕ ПРЕДПРИЯТИЕ	36
ФГУП	ФЕДЕРАЛЬНОГО ГОСУДАРСТВЕННОГО УНИТАРНОГО ПРЕДПРИЯТИЯ	1
ОШ	ОБЩЕОБРАЗОВАТЕЛЬНАЯ ШКОЛА	34
ОШ	ОСНОВНАЯ ШКОЛА	2
ВО	ВЫСШЕГО ОБРАЗОВАНИЯ	26
ВО	ВОЕННОГО ОБРАЗОВАТЕЛЬНОГО	7
ОАО	ОТКРЫТОГО АКЦИОНЕРНОГО ОБЩЕСТВА	6
ОАО	ОТКРЫТОЕ АКЦИОНЕРНОЕ ОБЩЕСТВО	19
ВОА	ВСЕРОССИЙСКОЕ ОБЩЕСТВО АВТОМОБИЛИСТОВ	7
ВОА	ВСЕРОССИЙСКОГО ОБЩЕСТВА АВТОМОБИЛИСТОВ	2
ГКУ	ГОСУДАРСТВЕННОЕ КАЗЕННОЕ УЧРЕЖДЕНИЕ	13
ГКУ	ГОСУДАРСТВЕННОГО КАЗЕННОГО УЧРЕЖДЕНИЯ	17
СО	СИБИРСКОЕ ОТДЕЛЕНИЕ	2
СО	САМАРСКОЙ ОБЛАСТИ	1
СО	САРАТОВСКИЙ ОБЛАСТНОЙ	6
СО	СВЕРДЛОВСКОЙ ОБЛАСТИ	8
СО	СОЦИАЛЬНОГО ОБСЛУЖИВАНИЯ	1
СО	САРАТОВСКОЙ ОБЛАСТИ	2
УЦ	УЧЕБНЫЙ ЦЕНТР	16
УЦ	УЦ "ЦИТАДЕЛЬ	1
ВО	ВЫСШЕГО ОБРАЗОВАНИЯ	15
ПО	ПРОФЕССИОНАЛЬНОГО ОБРАЗОВАНИЯ	9
ПО	ПРОФЕССИОНАЛЬНАЯ ОБРАЗОВАТЕЛЬНАЯ	1
НОЧУ	НЕГОСУДАРСТВЕННОЕ ОБРАЗОВАТЕЛЬНОЕ ЧАСТНОЕ УЧРЕЖДЕНИЕ	24
НОЧУ	НЕГОСУДАРСТВЕННОГО ОБРАЗОВАТЕЛЬНОГО ЧАСТНОГО УЧРЕЖДЕНИЯ	1
МАДОУ	МУНИЦИПАЛЬНОЕ АВТОНОМНОЕ ДОШКОЛЬНОЕ ОБРАЗОВАТЕЛЬНОЕ УЧРЕЖДЕНИЕ	22
ГКОУ	ГОСУДАРСТВЕННОГО КАЗЕННОГО ОБРАЗОВАТЕЛЬНОГО УЧРЕЖДЕНИЯ	20
ГКОУ	ГОСУДАРСТВЕННОГО КАЗЕННОГО ОБЩЕОБРАЗОВАТЕЛЬНОГО УЧРЕЖДЕНИЯ	2
ФГКУ	ФЕДЕРАЛЬНОГО ГОСУДАРСТВЕННОГО s УЧРЕЖДЕНИЯ	22
РС	РЕСПУБЛИКИ САХА	19
РС	РЕСП САХА	2
ЧУ	ЧАСТНОЕ УЧРЕЖДЕНИЕ	20
ЧУ	ЧАСТНОГО УЧРЕЖДЕНИЯ	1
МКУ	МУНИЦИПАЛЬНОГО КАЗЕННОГО УЧРЕЖДЕНИЯ	20
НПО	НАУЧНО-ПРОИЗВОДСТВЕННОЕ ОБЪЕДИНЕНИЕ	2
НПО	НАЧАЛЬНОГО ПРОФЕССИОНАЛЬНОГО ОБРАЗОВАНИЯ	5
ВЗФЭИ	ВСЕРОССИЙСКИЙ ЗАОЧНЫЙ ФИНАНСОВО-ЭКОНОМИЧЕСКИЙ ИНСТИТУТ	20
НП	НП ПЕРМЬ	8
НП	НЕКОММЕРЧЕСКОЕ ПАРТНЕРСТВО	10
ИПК	ИНСТИТУТ ПОВЫШЕНИЯ КВАЛИФИКАЦИИ	8
ИПК	ИНСТИТУТ ПОДГОТОВКИ КАДРОВ	9
ДМШ	ДЕТСКАЯ МУЗЫКАЛЬНАЯ ШКОЛА	17
АНОО	АВТОНОМНАЯ НЕКОММЕРЧЕСКАЯ ОБРАЗОВАТЕЛЬНАЯ ОРГАНИЗАЦИЯ	16
МИЭП	МОСКОВСКИЙ ИНСТИТУТ ЭКОНОМИЧЕСКИХ ПРЕОБРАЗОВАНИЙ	16
ГУП	ГОСУДАРСТВЕННОЕ УНИТАРНОЕ ПРЕДПРИЯТИЕ	15
РК	РЕСП КОМИ	4
РК	РЕСПУБЛИКИ КОМИ	10
МБДОУ	МУНИЦИПАЛЬНОЕ БЮДЖЕТНОЕ ДОШКОЛЬНОЕ ОБРАЗОВАТЕЛЬНОЕ УЧРЕЖДЕНИЕ	15
НПП	НАУЧНО-ПРОИЗВОДСТВЕННОЕ ПРЕДПРИЯТИЕ	13
ГК	ГУМАНИТАРНЫЙ КОЛЛЕДЖ	10
ИГУПИТ	ИНСТИТУТ ГОСУДАРСТВЕННОГО УПРАВЛЕНИЯ, ПРАВА И ИННОВАЦИОННЫХ ТЕХНОЛОГИЙ	14
ФГАУ	ФЕДЕРАЛЬНОЕ ГОСУДАРСТВЕННОЕ АВТОНОМНОЕ УЧРЕЖДЕНИЕ	12
ФГАУ	ФЕДЕРАЛЬНОГО ГОСУДАРСТВЕННОГО АВТОНОМНОГО УЧРЕЖДЕНИЯ	1
АСФ	АВАРИЙНО - СПАСАТЕЛЬНОЕ ФОРМИРОВАНИЕ	7
АСФ	АСФ "СВПФВЧ" - ФИЛИАЛ	2
АСФ	АВАРИЙНО-СПАСАТЕЛЬНОЕ ФОРМИРОВАНИЕ	4
МИКБ	МОСКОВСКИЙ ИНСТИТУТ КОМПЛЕКСНОЙ БЕЗОПАСНОСТИ	13
НТЦ	НАУЧНО - ТЕХНИЧЕСКИЙ ЦЕНТР	6
НТЦ	НАУЧНО-ТЕХНИЧЕСКИЙ ЦЕНТР	5
МКОУ	МУНИЦИПАЛЬНОЕ КАЗЕННОЕ ОБЩЕОБРАЗОВАТЕЛЬНОЕ УЧРЕЖДЕНИЕ	10
МКОУ	МУНИЦИПАЛЬНОЕ КАЗЁННОЕ ОБЩЕОБРАЗОВАТЕЛЬНОЕ УЧРЕЖДЕНИЕ	1
ФАУ	ФЕДЕРАЛЬНОЕ АВТОНОМНОЕ УЧРЕЖДЕНИЕ	12
ИТЦ	ИНЖЕНЕРНО-ТЕХНИЧЕСКИЙ ЦЕНТР	9
НК	НЕФТЕЮГАНСКИЙ КОРПОРАТИВНЫЙ	3
ЧПОУ	ЧАСТНОЕ ПРОФЕССИОНАЛЬНОЕ ОБРАЗОВАТЕЛЬНОЕ УЧРЕЖДЕНИЕ	10
ЧПОУ	ЧАСТНОГО ПРОФЕССИОНАЛЬНОГО ОБРАЗОВАТЕЛЬНОГО УЧРЕЖДЕНИЯ	1
ЦДПО	ЦЕНТР ДОПОЛНИТЕЛЬНОГО И ПРОФЕССИОНАЛЬНОГО ОБРАЗОВАНИЯ	1
ЦДПО	ЦЕНТР ДОПОЛНИТЕЛЬНОГО ПРОФЕССИОНАЛЬНОГО ОБРАЗОВАНИЯ	9
МКОУ	МУНИЦИПАЛЬНОГО КАЗЕННОГО ОБРАЗОВАТЕЛЬНОГО УЧРЕЖДЕНИЯ	2
МКОУ	МУНИЦИПАЛЬНОГО КАЗЕННОГО ОБЩЕОБРАЗОВАТЕЛЬНОГО УЧРЕЖДЕНИЯ	9
ВШПП	ВЫСШАЯ ШКОЛА ПРИВАТИЗАЦИИ И ПРЕДПРИНИМАТЕЛЬСТВА	11
ИМУИУ	ИНСТИТУТ МЕЖДУНАРОДНОГО УЧЁТА И УПРАВЛЕНИЯ	11
МАУ	МУНИЦИПАЛЬНОГО АВТОНОМНОГО УЧРЕЖДЕНИЯ	10
ТЭК	ТОПЛИВНО-ЭНЕРГЕТИЧЕСКОГО КОМПЛЕКСА	8
ЦФО	ЦЕНТРАЛЬНОМУ ФЕДЕРАЛЬНОМУ ОКРУГУ	9
ЛАБ	ЛИДЕРСТВА И АДМИНИСТРИРОВАНИЯ БИЗНЕС	2
СО	СИБИРСКОЕ ОТДЕЛЕНИЕ	2
СО	СИБИРСКОГО ОТДЕЛЕНИЯ	8
БРУКК	БАШКИРСКИЙ РЕСПУБЛИКАНСКИЙ УЧЕБНО-КУРСОВОЙ КОМБИНАТ	9
НПО	НАЧАЛЬНОГО ПРОФЕССИОНАЛЬНОГО ОБРАЗОВАНИЯ	10
МКДОУ	МУНИЦИПАЛЬНОЕ КАЗЕННОЕ ДОШКОЛЬНОЕ ОБРАЗОВАТЕЛЬНОЕ УЧРЕЖДЕНИЕ	9
МКДОУ	МУНИЦИПАЛЬНОЕ КАЗЁННОЕ ДОШКОЛЬНОЕ ОБРАЗОВАТЕЛЬНОЕ УЧРЕЖДЕНИЕ	1
СШ	СПОРТИВНАЯ ШКОЛА	10
ЗДШИ	ЗАВЬЯЛОВСКАЯ ДЕТСКАЯ ШКОЛА ИСКУССТВ	9
ДХШ	ДЕТСКАЯ ХУДОЖЕСТВЕННАЯ ШКОЛА	9
МОУ	МУНИЦИПАЛЬНОЕ ОБРАЗОВАТЕЛЬНОЕ УЧРЕЖДЕНИЕ	2
МОУ	МУНИЦИПАЛЬНОЕ ОБЩЕОБРАЗОВАТЕЛЬНОЕ УЧРЕЖДЕНИЕ	5
ПФО	ПРИВОЛЖСКОМУ ФЕДЕРАЛЬНОМУ ОКРУГУ	8
ПФО	ПРИВОЛЖСКОМ ФЕДЕРАЛЬНОМ ОКРУГЕ	1
РЭА	РОССИЙСКОЕ ЭНЕРГЕТИЧЕСКОЕ АГЕНТСТВО	9
ЭТС	ЭЛЕКТРОННЫЕ ТОРГОВЫЕ СИСТЕМЫ	9
УЦГН	УЧЕБНЫЙ ЦЕНТР ГАЗ-НЕФТЬ	9
ДПП	ДИСТАНЦИОННОЙ ПРОФЕССИОНАЛЬНОЙ ПОДГОТОВКИ	9
ПП	ПРОФЕССИОНАЛЬНОЙ ПОДГОТОВКИ	9
ИСО	ИНЖИНИРИНГ СТРОИТЕЛЬСТВО ОБСЛУЖИВАНИЕ	9
ЦТО	ЦЕНТР ТЕХНОЛОГИЧЕСКОГО ОБУЧЕНИЯ	9
ЦРВСП	ЦЕНТР РАЗВИТИЯ ВОЕННО-СПОРТИВНОЙ ПОДГОТОВКИ	9
ИГТА	ИВАНОВСКАЯ ГОСУДАРСТВЕННАЯ ТЕКСТИЛЬНАЯ АКАДЕМИЯ	9
УАВР	УПРАВЛЕНИЕ АВАРИЙНО-ВОССТАНОВИТЕЛЬНЫХ РАБОТ	7
ХК	ХОЛДИНГОВАЯ КОМПАНИЯ	8
МО	МУНИЦИПАЛЬНОГО ОБРАЗОВАНИЯ	5
ЮГ	ЮГ" (Г	1
ПОУ	ПРОФЕССИОНАЛЬНОЕ ОБРАЗОВАТЕЛЬНОЕ УЧРЕЖДЕНИЕ	8
КГУП	КРАЕВОЕ ГОСУДАРСТВЕННОЕ УНИТАРНОЕ ПРЕДПРИЯТИЕ	8
ПОУ	ПРОФЕССИОНАЛЬНОГО ОБРАЗОВАТЕЛЬНОГО УЧРЕЖДЕНИЯ	2
ПОУ	ПРОФЕССИОНАЛЬНОЕ ОБРАЗОВАТЕЛЬНОЕ УЧРЕЖДЕНИЕ	6
АПО	АССОЦИАЦИЯ ПРОФЕССИОНАЛЬНОГО ОБРАЗОВАНИЯ	8
УМЦ	УЧЕБНО-МЕТОДИЧЕСКИЙ ЦЕНТР	7
ФГОУ	ФЕДЕРАЛЬНОЕ ГОСУДАРСТВЕННОЕ ОБРАЗОВАТЕЛЬНОЕ УЧРЕЖДЕНИЕ	4
ФГОУ	ФЕДЕРАЛЬНОГО ГОСУДАРСТВЕННОГО ОБРАЗОВАТЕЛЬНОГО УЧРЕЖДЕНИЯ	4
ЦППМСП	ЦЕНТР ПСИХОЛОГО-ПЕДАГОГИЧЕСКОЙ, МЕДИЦИНСКОЙ И СОЦИАЛЬНОЙ ПОМОЩИ	8
МОУККАТ	МОСКОВСКИЙ ОБЛАСТНОЙ УЧЕБНО-КУРСОВОЙ КОМБИНАТ АВТОМОБИЛЬНОГО ТРАНСПОРТА	8
БУ	БЮДЖЕТНОЕ УЧРЕЖДЕНИЕ	7
БУ	БЮДЖЕТНОГО УЧРЕЖДЕНИЯ	1
ГОУ	ГОСУДАРСТВЕННОЕ ОБРАЗОВАТЕЛЬНОЕ УЧРЕЖДЕНИЕ	5
ГОУ	ГОСУДАРСТВЕННОГО ОБРАЗОВАТЕЛЬНОГО УЧРЕЖДЕНИЯ	2
КГТЭИ	КРАСНОЯРСКИЙ ГОСУДАРСТВЕННЫЙ ТОРГОВО-ЭКОНОМИЧЕСКИЙ ИНСТИТУТ	8
КОУ	КАЗЕННОГО ОБРАЗОВАТЕЛЬНОГО УЧРЕЖДЕНИЯ	8
ПТЭК	ПЕНЗЕНСКИЙ ТОРГОВО-ЭКОНОМИЧЕСКИЙ КОЛЛЕДЖ	8
МГАКХИС	МОСКОВСКАЯ ГОСУДАРСТВЕННАЯ АКАДЕМИЯ КОММУНАЛЬНОГО ХОЗЯЙСТВА И СТРОИТЕЛЬСТВА	8
УС	УПРАВЛЕНИЕ СВЯЗИ	7
ЦСППСИМ	ЦЕНТР СОЦИАЛЬНО-ПСИХОЛОГИЧЕСКОЙ ПОДДЕРЖКИ СЕМЬИ И МОЛОДЕЖИ	7
МУДО	МУНИЦИПАЛЬНОЕ УЧРЕЖДЕНИЕ ДОПОЛНИТЕЛЬНОГО ОБРАЗОВАНИЯ	6
ГБУЗ	ГОСУДАРСТВЕННОЕ БЮДЖЕТНОЕ УЧРЕЖДЕНИЕ ЗДРАВООХРАНЕНИЯ	7
ВЧ	ВОЕНИЗИРОВАННАЯ ЧАСТЬ	7
ПГТ	П.Г.Т	2
МУ	МУНИЦИПАЛЬНОЕ УЧРЕЖДЕНИЕ	7
ГО	ГРАЖДАНСКОЙ ОБОРОНЕ	3
ГО	ГРАЖДАНСКОЙ ОБОРОНЫ	2
ЧС	ЧРЕЗВЫЧАЙНЫМ СИТУАЦИЯМ	3
ЧС	ЧРЕЗВЫЧАЙНЫХ СИТУАЦИЙ	2
НЦБРСП	НАЦИОНАЛЬНЫЙ ЦЕНТР БЕЗОПАСНОСТИ РЫБНОЙ И СЕЛЬСКОХОЗЯЙСТВЕННОЙ ПРОДУКЦИИ	7
ГБУПК	ГОСУДАРСТВЕННОЕ БЮДЖЕТНОЕ УЧРЕЖДЕНИЕ ПЕРМСКОГО КРАЯ	7
АУ	АВТОНОМНОЕ УЧРЕЖДЕНИЕ	7
МОЭК	МОСКОВСКАЯ ОБЪЕДИНЕННАЯ ЭНЕРГЕТИЧЕСКАЯ КОМПАНИЯ	7
РАРК	РЕГИОНАЛЬНОЕ АГЕНТСТВО РАЗВИТИЯ КВАЛИФИКАЦИЙ	7
РИР	РОСАТОМ ИНФРАСТРУКТУРНЫЕ РЕШЕНИЯ	7
ВТЭП	ВЛАДИМИРСКИЙ ТЕХНИКУМ ЭКОНОМИКИ И ПРАВА	7
ИСЭ	ИНСТИТУТ СОВРЕМЕННОЙ ЭКОНОМИКИ	7
ИМ	ИНТЕГРАТИВНЫХ МЕТОДИК	1
АШ	АВТОМОБИЛЬНАЯ ШКОЛА	4
СК	СК (КРАЙ	5
МАУ	МУНИЦИПАЛЬНОЕ АВТОНОМНОЕ УЧРЕЖДЕНИЕ	6
МКУ	МУНИЦИПАЛЬНОЕ КАЗЕННОЕ УЧРЕЖДЕНИЕ	6
МКУДО	МУНИЦИПАЛЬНОЕ КАЗЕННОЕ УЧРЕЖДЕНИЕ ДОПОЛНИТЕЛЬНОГО ОБРАЗОВАНИЯ	6
КО	КАЛУЖСКОЙ ОБЛАСТИ	5
МБОУДО	МУНИЦИПАЛЬНОЕ БЮДЖЕТНОЕ ОБРАЗОВАТЕЛЬНОЕ УЧРЕЖДЕНИЕ ДОПОЛНИТЕЛЬНОГО ОБРАЗОВАНИЯ	6
СФО	СИБИРСКОМУ ФЕДЕРАЛЬНОМУ ОКРУГУ	6
ДП	ДОГОВОРНЫХ ПОДРАЗДЕЛЕНИЙ	5
УЦТО	УРАЛЬСКИЙ ЦЕНТР ТЕХНИЧЕСКОГО ОБУЧЕНИЯ	6
МАОУ	МУНИЦИПАЛЬНОГО АВТОНОМНОГО ОБРАЗОВАТЕЛЬНОГО УЧРЕЖДЕНИЯ	5
МАОУ	МУНИЦИПАЛЬНОЕ АВТОНОМНОЕ ОБРАЗОВАТЕЛЬНОЕ УЧРЕЖДЕНИЕ	1
МАОУ	МУНИЦИПАЛЬНОЕ АВТОНОМНОЕ ОБЩЕОБРАЗОВАТЕЛЬНОЕ УЧРЕЖДЕНИЕ	3
ДОД	ДОПОЛНИТЕЛЬНОГО ОБРАЗОВАНИЯ ДЕТСКАЯ	1
ДОД	ДОПОЛНИТЕЛЬНОГО ОБРАЗОВАНИЯ ДЕТЕЙ	2
ГОК	ГОРНО-ОБОГАТИТЕЛЬНЫЙ КОМБИНАТ	3
УПЦ	УЧЕБНО-ПРОИЗВОДСТВЕННЫЙ ЦЕНТР	4
УПЦ	УЧЕБНО-ПРОФЕССИОНАЛЬНЫЙ ЦЕНТР	1
МСЧ	МЕДИКО-САНИТАРНАЯ ЧАСТЬ	5
СКЗ	СЛУЖБА КОРПОРАТИВНОЙ ЗАЩИТЫ	5
МОУ	МУНИЦИПАЛЬНОГО ОБРАЗОВАТЕЛЬНОГО УЧРЕЖДЕНИЯ	5
ЛМО	ЛЕВОКУМСКОГО МУНИЦИПАЛЬНОГО ОКРУГА	5
БДШИ	БЕРЕСЛАВСКАЯ ДЕТСКАЯ ШКОЛА ИСКУССТВ	1
БДШИ	БОРОГОНСКАЯ ДЕТСКАЯ ШКОЛА ИСКУССТВ	2
БДШИ	БУЛГУННЯХТАХСКАЯ ДЕТСКАЯ ШКОЛА ИСКУССТВ	2
НДКО	НАРКОЛОГИЧЕСКИЙ ДИСПАНСЕР КАЛУЖСКОЙ ОБЛАСТИ	5
ППК	ПУБЛИЧНО-ПРАВОВАЯ КОМПАНИЯ	4
УЛ	УЛ. ЛЕСНАЯ	1
ТПП	ТОРГОВО-ПРОМЫШЛЕННАЯ ПАЛАТА	1
ГБУК	ГОСУДАРСТВЕННОЕ БЮДЖЕТНОЕ УЧРЕЖДЕНИЕ КУЛЬТУРЫ	5
ЛО	ЛЕНИНГРАДСКОЙ ОБЛАСТИ	4
АНПОО	АВТОНОМНАЯ НЕКОММЕРЧЕСКАЯ ПРОФЕССИОНАЛЬНАЯ ОБРАЗОВАТЕЛЬНАЯ ОРГАНИЗАЦИЯ	5
ФПС	ФЕДЕРАЛЬНОЙ ПРОТИВОПОЖАРНОЙ СЛУЖБЫ	5
РАД	РОССИЙСКИЙ АУКЦИОННЫЙ ДОМ	5
РАНОВПО	РЕГИОНАЛЬНАЯ АВТОНОМНАЯ НЕКОММЕРЧЕСКАЯ ОРГАНИЗАЦИЯ ВЫСШЕГО ПРОФЕССИОНАЛЬНОГО ОБРАЗОВАНИЯ	5
СВГИ	СЕВЕРО-ВОСТОЧНЫЙ ГУМАНИТАРНЫЙ ИНСТИТУТ	5
ФСИН	ФЕДЕРАЛЬНОЙ СЛУЖБЫ ИСПОЛНЕНИЯ НАКАЗАНИЙ	5
ОСОШ	ОТКРЫТАЯ (СМЕННАЯ) ОБЩЕОБРАЗОВАТЕЛЬНАЯ ШКОЛА	5
ГНИИ	ГОСУДАРСТВЕННЫЙ НАУЧНО-ИССЛЕДОВАТЕЛЬСКИЙ ИНСТИТУТ	5
РНС	РАЗВИТИЯ НАЛОГОВОЙ СИСТЕМЫ	5
МБОУДОД	МУНИЦИПАЛЬНОЕ БЮДЖЕТНОЕ ОБРАЗОВАТЕЛЬНОЕ УЧРЕЖДЕНИЕ ДОПОЛНИТЕЛЬНОГО ОБРАЗОВАНИЯ "ДЕТСКАЯ	1
МБОУДОД	МУНИЦИПАЛЬНОЕ БЮДЖЕТНОЕ ОБРАЗОВАТЕЛЬНОЕ УЧРЕЖДЕНИЕ ДОПОЛНИТЕЛЬНОГО ОБРАЗОВАНИЯ ДЕТЕЙ	1
РП	РЕСПУБЛИКАНСКОЕ ПРЕДПРИЯТИЕ	4
ОФ	ОБОГАТИТЕЛЬНАЯ ФАБРИКА	1
ДЮАШ	ДЕТСКАЯ ЮНОШЕСКАЯ АВТОМОБИЛЬНАЯ ШКОЛА	4
ПДШИ	ПОДПОРОЖСКАЯ ДЕТСКАЯ ШКОЛА ИСКУССТВ	4
ГАОУ	ГОСУДАРСТВЕННОГО АВТОНОМНОГО ОБРАЗОВАТЕЛЬНОГО УЧРЕЖДЕНИЯ	4
УКЦ	УЧЕБНО-КОНСУЛЬТАЦИОННЫЙ ЦЕНТР	1
ФГБНУ	ФЕДЕРАЛЬНОЕ ГОСУДАРСТВЕННОЕ БЮДЖЕТНОЕ НАУЧНОЕ УЧРЕЖДЕНИЕ	4
РЖД	РОССИЙСКИЕ ЖЕЛЕЗНЫЕ ДОРОГИ	1
РУЦ	РЕГИОНАЛЬНЫЙ УЧЕБНЫЙ ЦЕНТР	4
КМО	КРАСНОГВАРДЕЙСКОГО МУНИЦИПАЛЬНОГО ОКРУГА	4
ПБ	ПОЖАРНОЙ БЕЗОПАСНОСТИ	2
УСЦ	УЧЕБНО-СПОРТИВНЫЙ ЦЕНТР	4
ЦПК	ЦЕНТР ПОДГОТОВКИ КАДРОВ	1
НВК	НОВАЯ ВАГОНОРЕМОНТНАЯ КОМПАНИЯ	4
ИТ	ИНФОРМАЦИОННЫХ ТЕХНОЛОГИЙ	1
УОМЗ	УРАЛЬСКИЙ ОПТИКО-МЕХАНИЧЕСКИЙ ЗАВОД	4
ИТТ	ИНСТИТУТ ТРАНСПОРТНЫХ ТЕХНОЛОГИЙ	4
МОБУ	МУНИЦИПАЛЬНОЕ ОБЩЕОБРАЗОВАТЕЛЬНОЕ БЮДЖЕТНОЕ УЧРЕЖДЕНИЕ	4
БКТ	БИРСКИЙ КООПЕРАТИВНЫЙ ТЕХНИКУМ	4
МИРТШБ	МОСКОВСКИЙ ИНСТИТУТ РЕКЛАМЫ, ТУРИЗМА, ШОУ - БИЗНЕСА	4
ИБП	ИНСТИТУТ БИЗНЕСА И ПОЛИТИКИ	4
РБ	РЕСПУБЛИКИ БАШКОРТОСТАН	3
МАУДО	МУНИЦИПАЛЬНОЕ АВТОНОМНОЕ УЧРЕЖДЕНИЕ ДОПОЛНИТЕЛЬНОГО ОБРАЗОВАНИЯ	3
УМТСИК	УПРАВЛЕНИЕ МАТЕРИАЛЬНО-ТЕХНИЧЕСКОГО СНАБЖЕНИЯ И КОМПЛЕКТАЦИИ	3
ОГАУ	ОБЛАСТНОЕ ГОСУДАРСТВЕННОЕ АВТОНОМНОЕ УЧРЕЖДЕНИЕ	3
НИИ	НАУЧНО-ИССЛЕДОВАТЕЛЬСКИЙ ИНСТИТУТ	1
ИКЦ	ИНЖЕНЕРНО-КОНСУЛЬТАЦИОННЫЙ ЦЕНТР	3
ТКЗ	ТАГАНРОГСКИЙ КОТЛОСТРОИТЕЛЬНЫЙ ЗАВОД	3
ЦАСЭО	ЦЕНТР АВАРИЙНО-СПАСАТЕЛЬНЫХ И ЭКОЛОГИЧЕСКИХ ОПЕРАЦИЙ	3
КАР	КРАСНОЯРСКАЯ АВТОШКОЛА РЕГИОНА	1
РОСИНТЕР	РЕСТОРАННАЯ ОБЪЕДИНЕННАЯ СЕТЬ И НОВЕЙШИЕ ТЕХНОЛОГИИ ЕВРОАМЕРИКАНСКОГО РАЗВИТИЯ	3
ЯРОКБ	ЯКУТСКАЯ РЕСПУБЛИКАНСКАЯ ОФТАЛЬМОЛОГИЧЕСКАЯ КЛИНИЧЕСКАЯ БОЛЬНИЦА	3
УК	УК "КУЗБАССРАЗРЕЗУГОЛЬ	1
ПЭИПК	ПЕТЕРБУРГСКИЙ ЭНЕРГЕТИЧЕСКИЙ ИНСТИТУТ ПОВЫШЕНИЯ КВАЛИФИКАЦИИ	3
ЧУДПО	ЧАСТНОЕ УЧРЕЖДЕНИЕ ДОПОЛНИТЕЛЬНОГО ПРОФЕССИОНАЛЬНОГО ОБРАЗОВАНИЯ	3
ХДШИ	ХАНДЫГСКАЯ ДЕТСКАЯ ШКОЛА ИСКУССТВ	3
ДГК	ДАЛЬНЕВОСТОЧНАЯ ГЕНЕРИРУЮЩАЯ КОМПАНИЯ	3
РО	РЕГИОНАЛЬНОГО ОТДЕЛЕНИЯ	3
МП	МУНИЦИПАЛЬНОЕ ПРЕДПРИЯТИЕ	3
ЭТ	ЭЛЕКТРИЧЕСКИЙ ТРАНСПОРТ	3
ГУ	ГЛАВНОЕ УПРАВЛЕНИЕ	3
МАЭОИТ	МЕЖРЕГИОНАЛЬНАЯ АКАДЕМИЯ ЭКСПЕРИМЕНТАЛЬНЫХ ОБРАЗОВАТЕЛЬНЫХ И ИННОВАЦИОННЫХ ТЕХНОЛОГИЙ	3
НУОС	НАЦИОНАЛЬНЫЙ УНИВЕРСИТЕТ ОЗДОРОВИТЕЛЬНОГО, СПОРТИВНОГО	3
ЖДН	ЖЕЛЕЗНЫЕ ДОРОГИ НОВОРОССИИ	3
ПЛ	ПРОФЕССИОНАЛЬНЫЙ ЛИЦЕЙ	2
КЧГБОУ	КАРАЧАЕВО-ЧЕРКЕССКОЕ ГОСУДАРСТВЕННОЕ БЮДЖЕТНОЕ ОБРАЗОВАТЕЛЬНОЕ УЧРЕЖДЕНИЕ	3
КЧЭТ	КАРАЧАЕВО-ЧЕРКЕССКИЙ ЭНЕРГЕТИЧЕСКИЙ ТЕХНИКУМ	3
КТТТ	КРАСНОДАРСКИЙ ТОРГОВО-ТЕХНОЛОГИЧЕСКИЙ ТЕХНИКУМ	3
НОШ	НАЧАЛЬНАЯ ОБЩЕОБРАЗОВАТЕЛЬНАЯ ШКОЛА	3
ВСОШ	ВЕЧЕРНЯЯ (СМЕННАЯ) ОБЩЕОБРАЗОВАТЕЛЬНАЯ ШКОЛА	3
ГБПОУ	ГОСУДАРСТВЕННОГО БЮДЖЕТНОГО ПРОФЕССИОНАЛЬНОГО ОБРАЗОВАТЕЛЬНОГО УЧРЕЖДЕНИЯ	3
АЧГАА	АЗОВО-ЧЕРНОМОРСКАЯ ГОСУДАРСТВЕННАЯ АГРОИНЖЕНЕРНАЯ АКАДЕМИЯ	3
ПУ	ПРОФЕССИОНАЛЬНОЕ УЧИЛИЩЕ	3
МВСОУ	МУНИЦИПАЛЬНОЕ ВЕЧЕРНЕЕ (СМЕННОЕ) ОБЩЕОБРАЗОВАТЕЛЬНОЕ УЧРЕЖДЕНИЕ	3
МВД	МИНИСТЕРСТВА ВНУТРЕННИХ ДЕЛ	3
ИГАСУ	ИВАНОВСКИЙ ГОСУДАРСТВЕННЫЙ АРХИТЕКТУРНО-СТРОИТЕЛЬНЫЙ УНИВЕРСИТЕТ	1
ИГАСУ	ИВАНОВСКИЙ ГОСУДАРСТВЕННЫЙ АРХИТЕКТОРНО-СТРОИТЕЛЬНЫЙ УНИВЕРСИТЕТ	2
ПООА	ПРОФЕССИОНАЛЬНАЯ ОБРАЗОВАТЕЛЬНАЯ ОРГАНИЗАЦИЯ - АССОЦИАЦИЯ	3
БК	БИЗНЕС-КОЛЛЕДЖ	3
ФАОУ	ФЕДЕРАЛЬНОЕ АВТОНОМНОЕ ОБРАЗОВАТЕЛЬНОЕ УЧРЕЖДЕНИЕ	3
МПЭТ	МОСКОВСКИЙ ПРОМЫШЛЕННО-ЭКОНОМИЧЕСКИЙ ТЕХНИКУМ	3
ОАНО	ОБРАЗОВАТЕЛЬНАЯ АВТОНОМНАЯ НЕКОММЕРЧЕСКАЯ ОРГАНИЗАЦИЯ	3
РГУИТП	РОССИЙСКИЙ ГОСУДАРСТВЕННЫЙ УНИВЕРСИТЕТ ИННОВАЦИОННЫХ ТЕХНОЛОГИЙ И ПРЕДПРИНИМАТЕЛЬСТВА	3
МР	МУНИЦИПАЛЬНОГО РАЙОНА	2
ГП	ГП. ПРИОБЬЕ	1
РНУ	РАЙОННОЕ НЕФТЕПРОВОДНОЕ УПРАВЛЕНИЕ	2
УОВОФ	УПРАВЛЕНИЕ ОРГАНИЗАЦИИ ВОССТАНОВЛЕНИЯ ОСНОВНЫХ ФОНДОВ	2
РМ	РЕСПУБЛИКИ МОРДОВИЯ	1
АК	АКЦИОНЕРНЫЙ КОММЕРЧЕСКИЙ	1
ЧОУДПО	ЧАСТНОЕ ОБРАЗОВАТЕЛЬНОЕ УЧРЕЖДЕНИЕ ДОПОЛНИТЕЛЬНОГО ПРОФЕССИОНАЛЬНОГО ОБРАЗОВАНИЯ	2
НПЦРД	НАУЧНО-ПРАКТИЧЕСКИЙ ЦЕНТР РЕАБИЛИТАЦИИ ДЕТЕЙ	2
ДМШ	ДЕТСКАЯ МУЗЫКАЛЬНАЯ ШКОЛА	2
СУС	СЕВЕРНОЕ УПРАВЛЕНИЕ СТРОИТЕЛЬСТВА	2
УТТИСТ	УПРАВЛЕНИЕ ТЕХНОЛОГИЧЕСКОГО ТРАНСПОРТА И СПЕЦИАЛЬНОЙ ТЕХНИКИ	2
ДС	ДЕТСКИЙ САНАТОРИЙ	1
СОУК	САМАРСКИЙ ОБЛАСТНОЙ УЧЕБНЫЙ КОМБИНАТ	2
ОГАОУ	ОБЛАСТНОГО ГОСУДАРСТВЕННОГО АВТОНОМНОГО ОБРАЗОВАТЕЛЬНОГО УЧРЕЖДЕНИЯ	2
НАК	НОВОМОСКОВСКАЯ АКЦИОНЕРНАЯ КОМПАНИЯ	2
ТО	ТЮМЕНСКОЙ ОБЛАСТИ	2
РЦППМСП	РЕСПУБЛИКАНСКИЙ ЦЕНТР ПСИХОЛОГО-ПЕДАГОГИЧЕСКОЙ, МЕДИЦИНСКОЙ И СОЦИАЛЬНОЙ ПОМОЩИ	2
ЦПО	ЦЕНТР ПРОФЕССИОНАЛЬНОГО ОБРАЗОВАНИЯ	2
ГАОУ	ГОСУДАРСТВЕННОЕ АВТОНОМНОЕ ОБРАЗОВАТЕЛЬНОЕ УЧРЕЖДЕНИЕ	2
ЦОПП	ЦЕНТР ОПЕРЕЖАЮЩЕЙ ПРОФЕССИОНАЛЬНОЙ ПОДГОТОВКИ	2
БИППИПК	БАЛАКОВСКИЙ ИНСТИТУТ ПРОФЕССИОНАЛЬНОЙ ПЕРЕПОДГОТОВКИ И ПОВЫШЕНИЯ КВАЛИФИКАЦИИ	2
ТОГКУ	ТАМБОВСКОЕ ОБЛАСТНОЕ ГОСУДАРСТВЕННОЕ КАЗЕННОЕ УЧРЕЖДЕНИЕ	2
ПСЦ	ПОЖАРНО-СПАСАТЕЛЬНЫЙ ЦЕНТР	2
АДПО	АССОЦИАЦИЯ ДОПОЛНИТЕЛЬНОГО ПРОФЕССИОНАЛЬНОГО ОБРАЗОВАНИЯ	2
ЭПБ	ЭКОЛОГИЧЕСКОЙ И ПРОМЫШЛЕННОЙ БЕЗОПАСНОСТИ	2
УЦДПО	УЧЕБНЫЙ ЦЕНТР ДОПОЛНИТЕЛЬНОГО ПРОФЕССИОНАЛЬНОГО ОБРАЗОВАНИЯ	2
ЮАШ	ЮНОШЕСКАЯ АВТОМОБИЛЬНАЯ ШКОЛА	2
ИСС	ИНФОРМАЦИОННЫЕ СПУТНИКОВЫЕ СИСТЕМЫ	1
ГАУК	ГОСУДАРСТВЕННОЕ АВТОНОМНОЕ УЧРЕЖДЕНИЕ КУЛЬТУРЫ	2
ТОНБ	ТЮМЕНСКАЯ ОБЛАСТНАЯ НАУЧНАЯ БИБЛИОТЕКА	2
ГПИСС	ГОСУДАРСТВЕННЫЙ ПРОЕКТНЫЙ ИНСТИТУТ СПЕЦИАЛЬНОГО СТРОИТЕЛЬСТВА	2
ОУ	ОБЩЕСТВЕННОЕ УЧРЕЖДЕНИЕ	1
ДПК	ДОБРОВОЛЬНАЯ ПОЖАРНАЯ КОМАНДА	1
УОЦ	УЧЕБНО-ОБРАЗОВАТЕЛЬНЫЙ ЦЕНТР	2
УАЗ	УЛЬЯНОВСКИЙ АВТОМОБИЛЬНЫЙ ЗАВОД	2
ГНИВЦ	ГЛАВНЫЙ НАУЧНЫЙ ИННОВАЦИОННЫЙ ВНЕДРЕНЧЕСКИЙ ЦЕНТР	2
ФНПЦ	ФЕДЕРАЛЬНЫЙ НАУЧНО-ПРОИЗВОДСТВЕННЫЙ ЦЕНТР	2
КГПА	КАРЕЛЬСКАЯ ГОСУДАРСТВЕННАЯ ПЕДАГОГИЧЕСКАЯ АКАДЕМИЯ	2
ШИ	ШКОЛА-ИНТЕРНАТ	2
ДЮСШ	ДЕТСКО-ЮНОШЕСКАЯ СПОРТИВНАЯ ШКОЛА	2
ГАПОУ	ГОСУДАРСТВЕННОГО АВТОНОМНОГО ПРОФЕССИОНАЛЬНОГО ОБРАЗОВАТЕЛЬНОГО УЧРЕЖДЕНИЯ	2
СТДОС	САРАТОВСКИЙ ТЕХНИКУМ ДИЗАЙНА ОДЕЖДЫ И СЕРВИСА	2
МГПИ	МИЧУРИНСКИЙ ГОСУДАРСТВЕННЫЙ ПЕДАГОГИЧЕСКИЙ ИНСТИТУТ	2
ВСШ	ВЕНЕВСКАЯ СРЕДНЯЯ ШКОЛА	2
МИСАО	МОСКОВСКИЙ ИНСТИТУТ СОВРЕМЕННОГО АКАДЕМИЧЕСКОГО ОБРАЗОВАНИЯ	2
ИСИ	ИНСТИТУТ СОВРЕМЕННОГО ИСКУССТВА	2
ШП	ШУЙСКОЕ ПРЕДСТАВИТЕЛЬСТВО	2
ГАУДО	ГОСУДАРСТВЕННОЕ АВТОНОМНОЕ УЧРЕЖДЕНИЕ ДОПОЛНИТЕЛЬНОГО ОБРАЗОВАНИЯ	2
АГО	АЧИТСКОГО ГОРОДСКОГО ОКРУГА	2
ВУНЦ	ВОЕННЫЙ УЧЕБНО-НАУЧНЫЙ ЦЕНТР	2
ВВС	ВОЕННО-ВОЗДУШНЫХ СИЛ	2
ВВА	ВОЕННО-ВОЗДУШНАЯ АКАДЕМИЯ	2
НШ	НАЧАЛЬНАЯ ШКОЛА	2
СГППК	САРАТОВСКИЙ ГОСУДАРСТВЕННЫЙ ПРОФЕССИОНАЛЬНО-ПЕДАГОГИЧЕСКИЙ КОЛЛЕДЖ	2
ИР	ИР РБ	1
УМТСК	УПРАВЛЕНИЕ МАТЕРИАЛЬНО-ТЕХНИЧЕСКОГО СНАБЖЕНИЯ И КОМПЛЕКТАЦИИ	1
УТТСТ	УПРАВЛЕНИЕ ТЕХНОЛОГИЧЕСКОГО ТРАНСПОРТА И СПЕЦИАЛЬНОЙ ТЕХНИКИ	1
ЦНППМ	ЦЕНТР НЕПРЕРЫВНОГО ПОВЫШЕНИЯ ПРОФЕССИОНАЛЬНОГО МАСТЕРСТВА	1
ДХ	ДЖЕБАРИКИ-ХАЯ	1
АТА	АВТОБАЗА ТЕХНОЛОГИЧЕСКОГО АВТОТРАНСПОРТА	1
УТК	УПРАВЛЕНИЕ ТЕХНИЧЕСКОГО КОНТРОЛЯ	1
РЦМК	РЕСПУБЛИКАНСКИЙ ЦЕНТР МЕДИЦИНЫ КАТАСТРОФ	1
МЗ	МИНИСТЕРСТВА ЗДРАВООХРАНЕНИЯ	1
КАУ	КРАЕВОЕ АВТОНОМНОЕ УЧРЕЖДЕНИЕ	1
АИРО	АЛТАЙСКИЙ ИНСТИТУТ РАЗВИТИЯ ОБРАЗОВАНИЯ	1
УМТС	УПРАВЛЕНИЕ МАТЕРИАЛЬНО-ТЕХНИЧЕСКОГО СНАБЖЕНИЯ	1
НМТП	НОВОРОССИЙСКИЙ МОРСКОЙ ТОРГОВЫЙ ПОРТ	1
ГХК	ГОРНО-ХИМИЧЕСКИЙ КОМБИНАТ	1
АМО	АЛЕКСАНДРОВСКОГО МУНИЦИПАЛЬНОГО ОКРУГА	1
ШИ	ШКОЛА ИСКУССТВ	1
МВЛ	МЕЖОБЛАСТНАЯ ВЕТЕРИНАРНАЯ ЛАБОРАТОРИЯ	1
ВХЗ	ВЛАДИМИРСКИЙ ХИМИЧЕСКИЙ ЗАВОД	1
ЧФМК	ЧЕРЕПОВЕЦКИЙ ФАНЕРНО-МЕБЕЛЬНЫЙ КОМБИНАТ	1
РДУ	РЕГИОНАЛЬНОЕ ДИСПЕТЧЕРСКОЕ УПРАВЛЕНИЕ	1
МБУДОСК	МУНИЦИПАЛЬНОЕ БЮДЖЕТНОЕ УЧРЕЖДЕНИЕ ДОПОЛНИТЕЛЬНОГО ОБРАЗОВАНИЯ СФЕРЫ КУЛЬТУРЫ	1
ЗСМК	ЗАПАДНО-СИБИРСКИЙ МЕТАЛЛУРГИЧЕСКИЙ КОМБИНАТ	1
ОУК	ОБЪЕДИНЕННАЯ УГОЛЬНАЯ КОМПАНИЯ	1
МУК	МЕЖШКОЛЬНЫЙ УЧЕБНЫЙ КОМБИНАТ	1
ВДШИ	ВОЛОСОВСКАЯ ДЕТСКАЯ ШКОЛА ИСКУССТВ	1
ФБУ	ФЕДЕРАЛЬНОГО БЮДЖЕТНОГО УЧРЕЖДЕНИЯ	1
ЦДШИ	ЦЕНТРАЛЬНАЯ ДЕТСКАЯ ШКОЛА ИСКУССТВ	1
ПЖТ	ПРОМЫШЛЕННЫЙ ЖЕЛЕЗНОДОРОЖНЫЙ ТРАНСПОРТ	1
БОУ	БЮДЖЕТНОЕ ОБРАЗОВАТЕЛЬНОЕ УЧРЕЖДЕНИЕ	1
БУЗ	БЮДЖЕТНОЕ УЧРЕЖДЕНИЕ ЗДРАВООХРАНЕНИЯ	1
НГТУ	НОВОЧЕРКАССКОГО ГОСУДАРСТВЕННОГО ТЕХНИЧЕСКОГО УНИВЕРСИТЕТА	1
РОУК	РОСТОВСКИЙ ОБЛАСТНОЙ УЧЕБНЫЙ КОМБИНАТ	1
КЦ	КВАЛИФИКАЦИОННЫЙ ЦЕНТР	1
ЖКХИЭ	ЖИЛИЩНО-КОММУНАЛЬНОГО ХОЗЯЙСТВА И ЭНЕРГЕТИКИ	1
ТПТА	ТВЕРСКОЕ ПРОИЗВОДСТВО ТОРМОЗНОЙ АППАРАТУРЫ	1
ЦПБС	ЦЕНТР ПРОФИЛАКТИКИ И БОРЬБЫ СО	1
ГБНОУ	ГОСУДАРСТВЕННОЕ БЮДЖЕТНОЕ НЕТИПОВОЕ ОБРАЗОВАТЕЛЬНОЕ УЧРЕЖДЕНИЕ	1
ЯМЗ	ЯРОСЛАВСКИЙ МОТОРНЫЙ ЗАВОД	1
ПОО	ПРОФЕССИОНАЛЬНАЯ ОБРАЗОВАТЕЛЬНАЯ ОРГАНИЗАЦИЯ	1
ЦПСО	ЦЕНТР ПОДГОТОВКИ СОТРУДНИКОВ ОХРАНЫ	1
УВО	УПРАВЛЕНИЕ ВЕДОМСТВЕННОЙ ОХРАНЫ	1
ДГКБ	ДЕТСКАЯ ГОРОДСКАЯ КЛИНИЧЕСКАЯ БОЛЬНИЦА	1
НПП	НАУЧНО-ПРОИЗВОДСТВЕННОЕ ПРЕДПРИЯТИЕ	1
ЗУМЦ	ЗОНАЛЬНЫЙ УЧЕБНО-МЕТОДИЧЕСКИЙ ЦЕНТР	1
БКЕ	БУРОВАЯ КОМПАНИЯ "ЕВРАЗИЯ	1
ДОЦ	ДЕТСКИЙ ОЗДОРОВИТЕЛЬНЫЙ ЦЕНТР	1
ЯРЭУ	ЯМБУРГСКОЕ РАЙОННОЕ ЭНЕРГЕТИЧЕСКОЕ УПРАВЛЕНИЕ	1
НАНО	НЕГОСУДАРСТВЕННАЯ АВТОНОМНАЯ НЕКОММЕРЧЕСКАЯ ОРГАНИЗАЦИЯ	1
ВПШ	ВЫСШАЯ ПРОФЕССИОНАЛЬНАЯ ШКОЛА	1
ДНТ	ДОМ НАРОДНОГО ТВОРЧЕСТВА	1
ФНЦО	ФЕДЕРАЛЬНЫЙ НАУЧНЫЙ ЦЕНТР ОВОЩЕВОДСТВА	1
ДДПО	ДОПОЛНИТЕЛЬНОГО И ДОПОЛНИТЕЛЬНОГО ПРОФЕССИОНАЛЬНОГО ОБРАЗОВАНИЯ	1
МАУК	МУНИЦИПАЛЬНОЕ АВТОНОМНОЕ УЧРЕЖДЕНИЕ КУЛЬТУРЫ	1
РФС	РОССИЙСКИЙ ФУТБОЛЬНЫЙ СОЮЗ	1
МАГМУ	МОСКОВСКАЯ АКАДЕМИЯ ГОСУДАРСТВЕННОГО И МУНИЦИПАЛЬНОГО УПРАВЛЕНИЯ	1
НФПК	НАЦИОНАЛЬНЫЙ ФОНД ПОДГОТОВКИ КАДРОВ	1
АОУ	АВТОНОМНОГО ОБРАЗОВАТЕЛЬНОГО УЧРЕЖДЕНИЯ	1
МБОДО	МУНИЦИПАЛЬНАЯ БЮДЖЕТНАЯ ОРГАНИЗАЦИЯ ДОПОЛНИТЕЛЬНОГО ОБРАЗОВАНИЯ	1
ББИ	БЮРО БУХГАЛТЕРСКОЙ ИНФОРМАЦИИ	1
УКК	УЧЕБНО-КУРСОВОЙ КОМБИНАТ	1
ЧДХШИ	ЧЕБОКСАРСКАЯ ДЕТСКАЯ ХУДОЖЕСТВЕННАЯ ШКОЛА ИСКУССТВ	1
ФБУЗ	ФЕДЕРАЛЬНОЕ БЮДЖЕТНОЕ УЧРЕЖДЕНИЕ ЗДРАВООХРАНЕНИЯ	1
АНОДПО	АВТОНОМНАЯ НЕКОММЕРЧЕСКАЯ ОРГАНИЗАЦИЯ ДОПОЛНИТЕЛЬНОГО ПРОФЕССИОНАЛЬНОГО ОБРАЗОВАНИЯ	1
ОДООЦ	ОБЛАСТНОЙ ДЕТСКИЙ ОЗДОРОВИТЕЛЬНО-ОБРАЗОВАТЕЛЬНЫЙ ЦЕНТР	1
УТЦ	УЧЕБНО-ТРЕНАЖЕРНЫЙ ЦЕНТР	1
БАЗ	БРЯНСКИЙ АВТОМОБИЛЬНЫЙ ЗАВОД	1
НПК	НАУЧНО-ПРОИЗВОДСТВЕННАЯ КОРПОРАЦИЯ	1
РМОУ	РОССИЙСКИЙ МЕЖДУНАРОДНЫЙ ОЛИМПИЙСКИЙ УНИВЕРСИТЕТ	1
ЦКТИС	ЦЕНТРАЛЬНЫЙ КОНСТРУКТОРСКО-ТЕХНОЛОГИЧЕСКИЙ ИНСТИТУТ СУДОРЕМОНТА	1
АУЦ	АРТЕМОВСКИЙ УЧЕБНЫЙ ЦЕНТР	1
МРСК	МЕЖРЕГИОНАЛЬНОЙ РАСПРЕДЕЛИТЕЛЬНОЙ СЕТЕВОЙ КОМПАНИИ	1
КК	КРАСНОДАРСКОГО КРАЯ	1
КЦРИ	КОМПЛЕКСНЫЙ ЦЕНТР РЕАБИЛИТАЦИИ ИНВАЛИДОВ	1
ГРПЗ	ГОСУДАРСТВЕННЫЙ РЯЗАНСКИЙ ПРИБОРНЫЙ ЗАВОД	1
МИНЦ	МЕЖДУНАРОДНЫЙ ИНФОРМАЦИОННЫЙ НОБЕЛЕВСКИЙ ЦЕНТР	1
ИИТТ	ИНСТИТУТ ИННОВАЦИОННЫХ ТРАНСПОРТНЫХ ТЕХНОЛОГИЙ	1
НИИАА	НАУЧНО-ИССЛЕДОВАТЕЛЬСКИЙ ИНСТИТУТ АВТОМАТИЧЕСКОЙ АППАРАТУРЫ	1
СПБ	СИСТЕМЫ ПОЖАРНОЙ БЕЗОПАСНОСТИ	1
СЮАШ	СПЕЦИАЛИЗИРОВАННАЯ ЮНОШЕСКАЯ АВТОМОБИЛЬНАЯ ШКОЛА	1
ОДПО	ОРГАНИЗАЦИЯ ДОПОЛНИТЕЛЬНОГО ПРОФЕССИОНАЛЬНОГО ОБРАЗОВАНИЯ	1
ЧПОУ	ЧАСТНОГО ПРОФЕССИОНАЛЬНОГО ОБРАЗОВАТЕЛЬНОГО УЧРЕЖДЕНИЯ	1
ЧР	ЧУВАШСКОЙ РЕСПУБЛИКЕ	1
КЦСОН	КОМПЛЕКСНЫЙ ЦЕНТР СОЦИАЛЬНОГО ОБСЛУЖИВАНИЯ НАСЕЛЕНИЯ	1
ОИПП	ОНЛАЙН ИНСТИТУТ ПРАКТИЧЕСКОЙ ПСИХОЛОГИИ	1
НЧОУ	НЕГОСУДАРСТВЕННОЕ ЧАСТНОЕ ОБРАЗОВАТЕЛЬНОЕ УЧРЕЖДЕНИЕ	1
ИПО	ИНСТИТУТ ПСИХОТЕРАПИИ ОНЛАЙН	1
МИИПП	МЕЖДУНАРОДНЫЙ ИНСТИТУТ ИМАГИНАТИВНОЙ ПСИХОДИНАМИЧЕСКОЙ ПСИХОТЕРАПИИ	1
НАПС	НАЦИОНАЛЬНАЯ АКАДЕМИЯ ПРОФЕССИОНАЛЬНЫХ СТАНДАРТОВ	1
ИПП	ИНСТИТУТ ПРОФЕССИОНАЛЬНОЙ ПОДГОТОВКИ	1
АУТЛОГ	АЛЬТЕРНАТИВНОЕ УПРАВЛЕНИЕ ТЕХНОЛОГИЯМИ, ЛОГИСТИКОЙ, ОБРАЗОВАНИЕМ ГРУПП	1
ВШДПО	ВЫСШАЯ ШКОЛА ДОПОЛНИТЕЛЬНОГО ПРОФЕССИОНАЛЬНОГО ОБРАЗОВАНИЯ	1
САБУ	СТОЛИЧНАЯ АКАДЕМИЯ БИЗНЕСА И УПРАВЛЕНИЯ	1
ФГАНУ	ФЕДЕРАЛЬНОГО ГОСУДАРСТВЕННОГО АВТОНОМНОГО НАУЧНОГО УЧРЕЖДЕНИЯ	1
ФГАНУ	ФЕДЕРАЛЬНОГО ГОСУДАРСТВЕННОГО АВТОНОМНОГО НАУЧНОГО УЧРЕЖДЕНИЯ	1
НИИХП	НАУЧНО-ИССЛЕДОВАТЕЛЬСКИЙ ИНСТИТУТ ХЛЕБОПЕКАРНОЙ ПРОМЫШЛЕННОСТИ	1
НИКИМТ	НАУЧНО-ИССЛЕДОВАТЕЛЬСКИЙ И КОНСТРУКТОРСКИЙ ИНСТИТУТ МОНТАЖНОЙ ТЕХНОЛОГИИ	1
РЖД	РОССИЙСКИЕ ЖЕЛЕЗНЫЕ ДОРОГИ	1
МОБУ	МУНИЦИПАЛЬНОГО ОБЩЕОБРАЗОВАТЕЛЬНОГО БЮДЖЕТНОГО УЧРЕЖДЕНИЯ	1
ВППО	ВЫСШЕГО И ПОСЛЕВУЗОВСКОГО ПРОФЕССИОНАЛЬНОГО ОБРАЗОВАНИЯ	1
БОУ	БЮДЖЕТНОГО ОБРАЗОВАТЕЛЬНОГО УЧРЕЖДЕНИЯ	1
МГИ	МЕЖДУНАРОДНЫЙ ГУМАНИТАРНЫЙ ИНСТИТУТ	1
НИЭМ	НОВОСИБИРСКИЙ ИНСТИТУТ ЭКОНОМИКИ И МЕНЕДЖМЕНТА	1
РИПИ	РОСТОВСКИЙ ИНСТИТУТ ПРИКЛАДНОЙ ИНФОРМАТИКИ	1
СТЭТ	САХАЛИНСКИЙ ТОПЛИВНО-ЭНЕРГЕТИЧЕСКИЙ ТЕХНИКУМ	1
ДДТ	ДОМ ДЕТСКОГО ТВОРЧЕСТВА	1
СОГБОУ	СМОЛЕНСКОЕ ОБЛАСТНОЕ ГОСУДАРСТВЕННОЕ БЮДЖЕТНОЕ ОБРАЗОВАТЕЛЬНОЕ УЧРЕЖДЕНИЕ	1
ЮНОШ	ЮМУРЧЕНСКАЯ НАЧАЛЬНАЯ ОБЩЕОБРАЗОВАТЕЛЬНАЯ ШКОЛА	1
ГНЦ	ГОСУДАРСТВЕННЫЙ НАУЧНЫЙ ЦЕНТР	1
АЭБ	АКАДЕМИЯ ЭКОНОМИЧЕСКОЙ БЕЗОПАСНОСТИ	1
ФНЦ	ФЕДЕРАЛЬНЫЙ НАУЧНЫЙ ЦЕНТР	1
МГАУ	МОСКОВСКИЙ ГОСУДАРСТВЕННЫЙ АГРОИНЖЕНЕРНЫЙ УНИВЕРСИТЕТ	1
ИМБ	ИНСТИТУТ МЕНЕДЖМЕНТА И БИЗНЕСА	1
КП	КОСТРОМСКОЕ ПРЕДСТАВИТЕЛЬСТВО	1
КЦДЮТЭ	КУЗБАССКИЙ ЦЕНТР ДЕТСКОГО И ЮНОШЕСКОГО ТУРИЗМА И ЭКСКУРСИЙ	1
ОО	ОРЛОВСКОЙ ОБЛАСТИ	1
НИЦ	НАЦИОНАЛЬНОГО ИССЛЕДОВАТЕЛЬСКОГО ЦЕНТРА	1
ГАСК	ГОСУДАРСТВЕННАЯ АКАДЕМИЯ СЛАВЯНСКОЙ КУЛЬТУРЫ	1
ГАПОУ	ГОСУДАРСТВЕННОЕ АВТОНОМНОЕ ПРОФЕССИОНАЛЬНОЕ ОБРАЗОВАТЕЛЬНОЕ УЧРЕЖДЕНИЕ	1
МДОУ	МУНИЦИПАЛЬНОЕ ДОШКОЛЬНОЕ ОБРАЗОВАТЕЛЬНОЕ УЧРЕЖДЕНИЕ	1
ЦОД	ЦЕНТР ОБРАБОТКИ ДОКУМЕНТОВ	1
ЗСГИ	ЗАПАДНО-СИБИРСКИЙ ГУМАНИТАРНЫЙ ИНСТИТУТ	1